,ubigeo_inei,DEPARTAMENTO,PROVINCIA,FECHA,CASOS,FALLECIDOS,FALLECIDOS_SINADEF,FALLECIDOS_2019,EXCESO_MUERTES
165,101,AMAZONAS,CHACHAPOYAS,202003,0,0,24,20,4
167,101,AMAZONAS,CHACHAPOYAS,202004,59,0,11,17,-6
169,101,AMAZONAS,CHACHAPOYAS,202005,181,4,19,14,5
171,101,AMAZONAS,CHACHAPOYAS,202006,130,4,27,16,11
173,101,AMAZONAS,CHACHAPOYAS,202007,192,2,14,22,-8
175,101,AMAZONAS,CHACHAPOYAS,202008,493,15,35,24,11
177,101,AMAZONAS,CHACHAPOYAS,202009,601,21,33,14,19
178,101,AMAZONAS,CHACHAPOYAS,202010,333,6,23,17,6
179,101,AMAZONAS,CHACHAPOYAS,202011,118,4,18,17,1
180,101,AMAZONAS,CHACHAPOYAS,202012,67,2,20,10,10
163,101,AMAZONAS,CHACHAPOYAS,202101,520,9,30,25,5
164,101,AMAZONAS,CHACHAPOYAS,202102,674,23,45,27,18
166,101,AMAZONAS,CHACHAPOYAS,202103,1040,28,39,20,19
168,101,AMAZONAS,CHACHAPOYAS,202104,1024,49,59,17,42
170,101,AMAZONAS,CHACHAPOYAS,202105,510,42,61,14,47
172,101,AMAZONAS,CHACHAPOYAS,202106,317,17,32,16,16
174,101,AMAZONAS,CHACHAPOYAS,202107,122,10,32,22,10
176,101,AMAZONAS,CHACHAPOYAS,202108,144,7,19,24,-5
219,102,AMAZONAS,BAGUA,202003,0,0,7,13,-6
221,102,AMAZONAS,BAGUA,202004,39,0,17,15,2
223,102,AMAZONAS,BAGUA,202005,177,7,16,13,3
225,102,AMAZONAS,BAGUA,202006,723,44,39,14,25
227,102,AMAZONAS,BAGUA,202007,1750,125,120,21,99
229,102,AMAZONAS,BAGUA,202008,2519,44,42,13,29
231,102,AMAZONAS,BAGUA,202009,2026,26,17,11,6
232,102,AMAZONAS,BAGUA,202010,500,9,16,15,1
233,102,AMAZONAS,BAGUA,202011,279,6,15,14,1
234,102,AMAZONAS,BAGUA,202012,113,5,6,3,3
217,102,AMAZONAS,BAGUA,202101,97,7,17,2,15
218,102,AMAZONAS,BAGUA,202102,155,17,21,17,4
220,102,AMAZONAS,BAGUA,202103,231,14,13,13,0
222,102,AMAZONAS,BAGUA,202104,593,27,27,15,12
224,102,AMAZONAS,BAGUA,202105,548,38,21,13,8
226,102,AMAZONAS,BAGUA,202106,312,18,16,14,2
228,102,AMAZONAS,BAGUA,202107,145,14,12,21,-9
230,102,AMAZONAS,BAGUA,202108,60,6,10,13,-3
237,103,AMAZONAS,BONGARA,202003,0,0,8,7,1
239,103,AMAZONAS,BONGARA,202004,14,1,4,2,2
241,103,AMAZONAS,BONGARA,202005,9,1,6,6,0
243,103,AMAZONAS,BONGARA,202006,22,0,4,9,-5
245,103,AMAZONAS,BONGARA,202007,58,2,8,9,-1
247,103,AMAZONAS,BONGARA,202008,89,5,11,10,1
249,103,AMAZONAS,BONGARA,202009,111,7,13,8,5
250,103,AMAZONAS,BONGARA,202010,42,5,7,14,-7
251,103,AMAZONAS,BONGARA,202011,22,0,6,6,0
252,103,AMAZONAS,BONGARA,202012,22,3,11,4,7
235,103,AMAZONAS,BONGARA,202101,66,6,16,11,5
236,103,AMAZONAS,BONGARA,202102,83,5,12,7,5
238,103,AMAZONAS,BONGARA,202103,151,4,6,7,-1
240,103,AMAZONAS,BONGARA,202104,243,9,14,2,12
242,103,AMAZONAS,BONGARA,202105,166,11,13,6,7
244,103,AMAZONAS,BONGARA,202106,73,2,9,9,0
246,103,AMAZONAS,BONGARA,202107,33,3,8,9,-1
248,103,AMAZONAS,BONGARA,202108,30,0,10,10,0
255,104,AMAZONAS,CONDORCANQUI,202003,0,0,1,2,-1
257,104,AMAZONAS,CONDORCANQUI,202004,0,0,2,3,-1
259,104,AMAZONAS,CONDORCANQUI,202005,3,2,5,0,5
261,104,AMAZONAS,CONDORCANQUI,202006,190,16,6,0,6
263,104,AMAZONAS,CONDORCANQUI,202007,1071,39,14,1,13
265,104,AMAZONAS,CONDORCANQUI,202008,980,4,1,3,-2
267,104,AMAZONAS,CONDORCANQUI,202009,461,5,6,2,4
268,104,AMAZONAS,CONDORCANQUI,202010,454,1,3,3,0
269,104,AMAZONAS,CONDORCANQUI,202011,227,1,2,2,0
270,104,AMAZONAS,CONDORCANQUI,202012,95,2,3,2,1
253,104,AMAZONAS,CONDORCANQUI,202101,39,1,3,3,0
254,104,AMAZONAS,CONDORCANQUI,202102,18,0,4,2,2
256,104,AMAZONAS,CONDORCANQUI,202103,68,5,14,2,12
258,104,AMAZONAS,CONDORCANQUI,202104,147,8,7,3,4
260,104,AMAZONAS,CONDORCANQUI,202105,110,5,5,0,5
262,104,AMAZONAS,CONDORCANQUI,202106,79,4,5,0,5
264,104,AMAZONAS,CONDORCANQUI,202107,19,1,5,1,4
266,104,AMAZONAS,CONDORCANQUI,202108,7,0,3,3,0
273,105,AMAZONAS,LUYA,202003,0,0,9,7,2
275,105,AMAZONAS,LUYA,202004,0,0,8,12,-4
277,105,AMAZONAS,LUYA,202005,22,3,8,7,1
279,105,AMAZONAS,LUYA,202006,108,2,12,13,-1
281,105,AMAZONAS,LUYA,202007,47,2,16,16,0
283,105,AMAZONAS,LUYA,202008,150,5,16,11,5
285,105,AMAZONAS,LUYA,202009,67,3,11,9,2
286,105,AMAZONAS,LUYA,202010,30,1,13,10,3
287,105,AMAZONAS,LUYA,202011,17,0,5,5,0
288,105,AMAZONAS,LUYA,202012,14,3,9,11,-2
271,105,AMAZONAS,LUYA,202101,21,4,16,17,-1
272,105,AMAZONAS,LUYA,202102,80,8,11,6,5
274,105,AMAZONAS,LUYA,202103,107,9,22,7,15
276,105,AMAZONAS,LUYA,202104,385,15,23,12,11
278,105,AMAZONAS,LUYA,202105,202,16,30,7,23
280,105,AMAZONAS,LUYA,202106,114,5,13,13,0
282,105,AMAZONAS,LUYA,202107,52,1,9,16,-7
284,105,AMAZONAS,LUYA,202108,44,2,13,11,2
291,106,AMAZONAS,RODRIGUEZ DE MENDOZA,202003,0,0,1,11,-10
293,106,AMAZONAS,RODRIGUEZ DE MENDOZA,202004,2,0,0,7,-7
295,106,AMAZONAS,RODRIGUEZ DE MENDOZA,202005,1,0,3,5,-2
297,106,AMAZONAS,RODRIGUEZ DE MENDOZA,202006,31,0,4,5,-1
299,106,AMAZONAS,RODRIGUEZ DE MENDOZA,202007,15,1,4,4,0
301,106,AMAZONAS,RODRIGUEZ DE MENDOZA,202008,14,1,5,9,-4
303,106,AMAZONAS,RODRIGUEZ DE MENDOZA,202009,13,2,3,7,-4
304,106,AMAZONAS,RODRIGUEZ DE MENDOZA,202010,12,2,4,7,-3
305,106,AMAZONAS,RODRIGUEZ DE MENDOZA,202011,4,0,4,3,1
306,106,AMAZONAS,RODRIGUEZ DE MENDOZA,202012,18,1,4,9,-5
289,106,AMAZONAS,RODRIGUEZ DE MENDOZA,202101,201,6,5,4,1
290,106,AMAZONAS,RODRIGUEZ DE MENDOZA,202102,183,12,12,6,6
292,106,AMAZONAS,RODRIGUEZ DE MENDOZA,202103,127,7,6,11,-5
294,106,AMAZONAS,RODRIGUEZ DE MENDOZA,202104,238,10,12,7,5
296,106,AMAZONAS,RODRIGUEZ DE MENDOZA,202105,108,5,14,5,9
298,106,AMAZONAS,RODRIGUEZ DE MENDOZA,202106,52,0,4,5,-1
300,106,AMAZONAS,RODRIGUEZ DE MENDOZA,202107,95,2,8,4,4
302,106,AMAZONAS,RODRIGUEZ DE MENDOZA,202108,41,2,5,9,-4
309,107,AMAZONAS,UTCUBAMBA,202003,0,0,18,19,-1
311,107,AMAZONAS,UTCUBAMBA,202004,49,1,22,18,4
313,107,AMAZONAS,UTCUBAMBA,202005,201,17,25,19,6
315,107,AMAZONAS,UTCUBAMBA,202006,553,29,25,21,4
317,107,AMAZONAS,UTCUBAMBA,202007,1028,32,25,20,5
319,107,AMAZONAS,UTCUBAMBA,202008,898,14,18,29,-11
321,107,AMAZONAS,UTCUBAMBA,202009,464,11,12,20,-8
322,107,AMAZONAS,UTCUBAMBA,202010,303,9,9,28,-19
323,107,AMAZONAS,UTCUBAMBA,202011,154,9,8,20,-12
324,107,AMAZONAS,UTCUBAMBA,202012,99,7,14,17,-3
307,107,AMAZONAS,UTCUBAMBA,202101,241,17,18,19,-1
308,107,AMAZONAS,UTCUBAMBA,202102,311,16,22,21,1
310,107,AMAZONAS,UTCUBAMBA,202103,367,20,23,19,4
312,107,AMAZONAS,UTCUBAMBA,202104,642,34,16,18,-2
314,107,AMAZONAS,UTCUBAMBA,202105,542,44,23,19,4
316,107,AMAZONAS,UTCUBAMBA,202106,335,21,17,21,-4
318,107,AMAZONAS,UTCUBAMBA,202107,163,15,23,20,3
320,107,AMAZONAS,UTCUBAMBA,202108,102,5,11,29,-18
1479,201,ANCASH,HUARAZ,202003,1,0,70,76,-6
1481,201,ANCASH,HUARAZ,202004,106,5,72,61,11
1483,201,ANCASH,HUARAZ,202005,437,28,87,70,17
1485,201,ANCASH,HUARAZ,202006,732,67,145,73,72
1487,201,ANCASH,HUARAZ,202007,1338,164,252,75,177
1489,201,ANCASH,HUARAZ,202008,1779,121,175,94,81
1491,201,ANCASH,HUARAZ,202009,883,47,88,73,15
1492,201,ANCASH,HUARAZ,202010,1019,20,75,70,5
1493,201,ANCASH,HUARAZ,202011,242,8,71,63,8
1494,201,ANCASH,HUARAZ,202012,204,12,64,83,-19
1477,201,ANCASH,HUARAZ,202101,709,56,115,65,50
1478,201,ANCASH,HUARAZ,202102,1139,68,133,60,73
1480,201,ANCASH,HUARAZ,202103,2266,109,179,76,103
1482,201,ANCASH,HUARAZ,202104,1940,140,229,61,168
1484,201,ANCASH,HUARAZ,202105,1321,118,196,70,126
1486,201,ANCASH,HUARAZ,202106,700,32,92,73,19
1488,201,ANCASH,HUARAZ,202107,500,27,97,75,22
1490,201,ANCASH,HUARAZ,202108,560,14,78,94,-16
1497,202,ANCASH,AIJA,202003,0,0,1,1,0
1499,202,ANCASH,AIJA,202004,0,0,5,3,2
1501,202,ANCASH,AIJA,202005,5,0,0,4,-4
1503,202,ANCASH,AIJA,202006,1,0,3,1,2
1505,202,ANCASH,AIJA,202007,8,0,6,2,4
1507,202,ANCASH,AIJA,202008,38,1,4,8,-4
1509,202,ANCASH,AIJA,202009,20,1,2,7,-5
1510,202,ANCASH,AIJA,202010,5,0,1,1,0
1511,202,ANCASH,AIJA,202011,1,0,2,3,-1
1512,202,ANCASH,AIJA,202012,1,0,3,4,-1
1495,202,ANCASH,AIJA,202101,7,0,6,2,4
1496,202,ANCASH,AIJA,202102,41,3,12,2,10
1498,202,ANCASH,AIJA,202103,55,5,9,1,8
1500,202,ANCASH,AIJA,202104,67,3,11,3,8
1502,202,ANCASH,AIJA,202105,19,3,8,4,4
1504,202,ANCASH,AIJA,202106,5,1,8,1,7
1506,202,ANCASH,AIJA,202107,31,0,5,2,3
1508,202,ANCASH,AIJA,202108,5,0,3,8,-5
1515,203,ANCASH,ANTONIO RAYMONDI,202003,0,0,4,4,0
1517,203,ANCASH,ANTONIO RAYMONDI,202004,0,0,4,6,-2
1519,203,ANCASH,ANTONIO RAYMONDI,202005,1,0,1,2,-1
1521,203,ANCASH,ANTONIO RAYMONDI,202006,3,0,3,4,-1
1523,203,ANCASH,ANTONIO RAYMONDI,202007,10,1,12,9,3
1525,203,ANCASH,ANTONIO RAYMONDI,202008,24,0,7,5,2
1527,203,ANCASH,ANTONIO RAYMONDI,202009,1,0,3,8,-5
1528,203,ANCASH,ANTONIO RAYMONDI,202010,10,1,4,5,-1
1529,203,ANCASH,ANTONIO RAYMONDI,202011,4,3,8,7,1
1530,203,ANCASH,ANTONIO RAYMONDI,202012,1,0,8,7,1
1513,203,ANCASH,ANTONIO RAYMONDI,202101,1,0,8,7,1
1514,203,ANCASH,ANTONIO RAYMONDI,202102,5,0,8,3,5
1516,203,ANCASH,ANTONIO RAYMONDI,202103,4,2,7,4,3
1518,203,ANCASH,ANTONIO RAYMONDI,202104,5,6,11,6,5
1520,203,ANCASH,ANTONIO RAYMONDI,202105,20,8,17,2,15
1522,203,ANCASH,ANTONIO RAYMONDI,202106,43,6,8,4,4
1524,203,ANCASH,ANTONIO RAYMONDI,202107,39,2,6,9,-3
1526,203,ANCASH,ANTONIO RAYMONDI,202108,1,0,4,5,-1
1533,204,ANCASH,ASUNCION,202003,0,0,4,4,0
1535,204,ANCASH,ASUNCION,202004,1,0,1,4,-3
1537,204,ANCASH,ASUNCION,202005,0,0,3,8,-5
1539,204,ANCASH,ASUNCION,202006,1,1,7,1,6
1541,204,ANCASH,ASUNCION,202007,2,0,6,5,1
1543,204,ANCASH,ASUNCION,202008,6,0,10,8,2
1545,204,ANCASH,ASUNCION,202009,4,0,0,10,-10
1546,204,ANCASH,ASUNCION,202010,12,1,3,14,-11
1547,204,ANCASH,ASUNCION,202011,30,0,5,9,-4
1548,204,ANCASH,ASUNCION,202012,3,1,2,8,-6
1531,204,ANCASH,ASUNCION,202101,6,0,6,7,-1
1532,204,ANCASH,ASUNCION,202102,33,1,4,2,2
1534,204,ANCASH,ASUNCION,202103,62,2,9,4,5
1536,204,ANCASH,ASUNCION,202104,71,7,14,4,10
1538,204,ANCASH,ASUNCION,202105,73,3,9,8,1
1540,204,ANCASH,ASUNCION,202106,21,3,8,1,7
1542,204,ANCASH,ASUNCION,202107,16,1,6,5,1
1544,204,ANCASH,ASUNCION,202108,10,0,2,8,-6
1551,205,ANCASH,BOLOGNESI,202003,0,0,11,7,4
1553,205,ANCASH,BOLOGNESI,202004,3,0,6,6,0
1555,205,ANCASH,BOLOGNESI,202005,4,1,12,14,-2
1557,205,ANCASH,BOLOGNESI,202006,17,1,9,8,1
1559,205,ANCASH,BOLOGNESI,202007,24,7,22,16,6
1561,205,ANCASH,BOLOGNESI,202008,63,3,15,12,3
1563,205,ANCASH,BOLOGNESI,202009,52,0,9,10,-1
1564,205,ANCASH,BOLOGNESI,202010,38,2,14,13,1
1565,205,ANCASH,BOLOGNESI,202011,18,5,15,8,7
1566,205,ANCASH,BOLOGNESI,202012,23,1,12,8,4
1549,205,ANCASH,BOLOGNESI,202101,69,3,15,7,8
1550,205,ANCASH,BOLOGNESI,202102,152,9,19,9,10
1552,205,ANCASH,BOLOGNESI,202103,199,13,28,7,21
1554,205,ANCASH,BOLOGNESI,202104,223,16,32,6,26
1556,205,ANCASH,BOLOGNESI,202105,154,9,16,14,2
1558,205,ANCASH,BOLOGNESI,202106,115,7,18,8,10
1560,205,ANCASH,BOLOGNESI,202107,63,3,12,16,-4
1562,205,ANCASH,BOLOGNESI,202108,28,1,9,12,-3
1569,206,ANCASH,CARHUAZ,202003,0,0,26,20,6
1571,206,ANCASH,CARHUAZ,202004,16,1,17,20,-3
1573,206,ANCASH,CARHUAZ,202005,14,4,20,27,-7
1575,206,ANCASH,CARHUAZ,202006,25,3,33,28,5
1577,206,ANCASH,CARHUAZ,202007,31,5,36,24,12
1579,206,ANCASH,CARHUAZ,202008,151,11,50,23,27
1581,206,ANCASH,CARHUAZ,202009,177,9,32,25,7
1582,206,ANCASH,CARHUAZ,202010,91,4,30,14,16
1583,206,ANCASH,CARHUAZ,202011,29,2,24,25,-1
1584,206,ANCASH,CARHUAZ,202012,18,1,28,26,2
1567,206,ANCASH,CARHUAZ,202101,68,5,30,25,5
1568,206,ANCASH,CARHUAZ,202102,79,5,33,24,9
1570,206,ANCASH,CARHUAZ,202103,258,22,59,20,39
1572,206,ANCASH,CARHUAZ,202104,357,33,78,20,58
1574,206,ANCASH,CARHUAZ,202105,127,23,52,27,25
1576,206,ANCASH,CARHUAZ,202106,56,9,32,28,4
1578,206,ANCASH,CARHUAZ,202107,65,2,19,24,-5
1580,206,ANCASH,CARHUAZ,202108,35,0,23,23,0
1587,207,ANCASH,CARLOS FERMIN FITZCARRALD,202003,0,0,2,5,-3
1589,207,ANCASH,CARLOS FERMIN FITZCARRALD,202004,0,0,8,5,3
1591,207,ANCASH,CARLOS FERMIN FITZCARRALD,202005,4,0,8,10,-2
1593,207,ANCASH,CARLOS FERMIN FITZCARRALD,202006,3,0,4,5,-1
1595,207,ANCASH,CARLOS FERMIN FITZCARRALD,202007,3,3,15,5,10
1597,207,ANCASH,CARLOS FERMIN FITZCARRALD,202008,8,2,15,1,14
1599,207,ANCASH,CARLOS FERMIN FITZCARRALD,202009,12,3,10,14,-4
1600,207,ANCASH,CARLOS FERMIN FITZCARRALD,202010,25,0,6,9,-3
1601,207,ANCASH,CARLOS FERMIN FITZCARRALD,202011,1,2,8,7,1
1602,207,ANCASH,CARLOS FERMIN FITZCARRALD,202012,0,0,12,11,1
1585,207,ANCASH,CARLOS FERMIN FITZCARRALD,202101,6,0,12,7,5
1586,207,ANCASH,CARLOS FERMIN FITZCARRALD,202102,19,0,8,7,1
1588,207,ANCASH,CARLOS FERMIN FITZCARRALD,202103,25,6,24,5,19
1590,207,ANCASH,CARLOS FERMIN FITZCARRALD,202104,22,7,24,5,19
1592,207,ANCASH,CARLOS FERMIN FITZCARRALD,202105,10,4,17,10,7
1594,207,ANCASH,CARLOS FERMIN FITZCARRALD,202106,1,1,7,5,2
1596,207,ANCASH,CARLOS FERMIN FITZCARRALD,202107,0,2,10,5,5
1598,207,ANCASH,CARLOS FERMIN FITZCARRALD,202108,0,0,4,1,3
1605,208,ANCASH,CASMA,202003,0,0,28,11,17
1607,208,ANCASH,CASMA,202004,40,6,27,11,16
1609,208,ANCASH,CASMA,202005,68,17,48,16,32
1611,208,ANCASH,CASMA,202006,179,40,86,16,70
1613,208,ANCASH,CASMA,202007,155,25,42,18,24
1615,208,ANCASH,CASMA,202008,194,18,31,9,22
1617,208,ANCASH,CASMA,202009,106,8,22,13,9
1618,208,ANCASH,CASMA,202010,141,5,16,16,0
1619,208,ANCASH,CASMA,202011,62,5,33,7,26
1620,208,ANCASH,CASMA,202012,18,5,22,20,2
1603,208,ANCASH,CASMA,202101,94,10,32,19,13
1604,208,ANCASH,CASMA,202102,189,19,37,20,17
1606,208,ANCASH,CASMA,202103,584,56,87,11,76
1608,208,ANCASH,CASMA,202104,509,70,105,11,94
1610,208,ANCASH,CASMA,202105,138,31,52,16,36
1612,208,ANCASH,CASMA,202106,63,10,40,16,24
1614,208,ANCASH,CASMA,202107,48,4,24,18,6
1616,208,ANCASH,CASMA,202108,16,0,19,9,10
1623,209,ANCASH,CORONGO,202003,0,0,2,1,1
1625,209,ANCASH,CORONGO,202004,0,0,0,2,-2
1627,209,ANCASH,CORONGO,202005,2,1,3,2,1
1629,209,ANCASH,CORONGO,202006,3,1,2,2,0
1631,209,ANCASH,CORONGO,202007,15,0,1,3,-2
1633,209,ANCASH,CORONGO,202008,3,0,2,3,-1
1635,209,ANCASH,CORONGO,202009,6,0,6,1,5
1636,209,ANCASH,CORONGO,202010,1,0,3,5,-2
1637,209,ANCASH,CORONGO,202011,3,0,3,2,1
1638,209,ANCASH,CORONGO,202012,4,0,3,4,-1
1621,209,ANCASH,CORONGO,202101,1,0,4,1,3
1622,209,ANCASH,CORONGO,202102,30,1,6,3,3
1624,209,ANCASH,CORONGO,202103,46,6,12,1,11
1626,209,ANCASH,CORONGO,202104,31,4,16,2,14
1628,209,ANCASH,CORONGO,202105,5,3,5,2,3
1630,209,ANCASH,CORONGO,202106,3,1,6,2,4
1632,209,ANCASH,CORONGO,202107,6,0,4,3,1
1634,209,ANCASH,CORONGO,202108,4,1,3,3,0
1641,210,ANCASH,HUARI,202003,0,0,23,34,-11
1643,210,ANCASH,HUARI,202004,28,0,26,20,6
1645,210,ANCASH,HUARI,202005,40,1,33,26,7
1647,210,ANCASH,HUARI,202006,17,5,33,21,12
1649,210,ANCASH,HUARI,202007,16,4,35,34,1
1651,210,ANCASH,HUARI,202008,77,13,43,36,7
1653,210,ANCASH,HUARI,202009,23,5,34,30,4
1654,210,ANCASH,HUARI,202010,23,3,22,25,-3
1655,210,ANCASH,HUARI,202011,25,1,29,31,-2
1656,210,ANCASH,HUARI,202012,26,5,34,36,-2
1639,210,ANCASH,HUARI,202101,52,6,36,36,0
1640,210,ANCASH,HUARI,202102,82,11,56,27,29
1642,210,ANCASH,HUARI,202103,117,17,56,34,22
1644,210,ANCASH,HUARI,202104,218,23,70,20,50
1646,210,ANCASH,HUARI,202105,172,19,59,26,33
1648,210,ANCASH,HUARI,202106,93,14,52,21,31
1650,210,ANCASH,HUARI,202107,52,4,35,34,1
1652,210,ANCASH,HUARI,202108,43,0,22,36,-14
1821,211,ANCASH,HUARMEY,202003,0,0,8,6,2
1823,211,ANCASH,HUARMEY,202004,7,5,17,10,7
1825,211,ANCASH,HUARMEY,202005,39,1,11,15,-4
1827,211,ANCASH,HUARMEY,202006,90,8,26,19,7
1829,211,ANCASH,HUARMEY,202007,319,15,31,12,19
1831,211,ANCASH,HUARMEY,202008,475,26,41,12,29
1833,211,ANCASH,HUARMEY,202009,323,7,20,8,12
1834,211,ANCASH,HUARMEY,202010,156,4,15,14,1
1835,211,ANCASH,HUARMEY,202011,78,2,15,15,0
1836,211,ANCASH,HUARMEY,202012,82,4,18,12,6
1819,211,ANCASH,HUARMEY,202101,151,11,18,24,-6
1820,211,ANCASH,HUARMEY,202102,254,10,27,15,12
1822,211,ANCASH,HUARMEY,202103,506,36,51,6,45
1824,211,ANCASH,HUARMEY,202104,388,51,63,10,53
1826,211,ANCASH,HUARMEY,202105,167,27,37,15,22
1828,211,ANCASH,HUARMEY,202106,41,7,24,19,5
1830,211,ANCASH,HUARMEY,202107,22,1,14,12,2
1832,211,ANCASH,HUARMEY,202108,25,1,19,12,7
1911,212,ANCASH,HUAYLAS,202003,0,0,24,23,1
1913,212,ANCASH,HUAYLAS,202004,13,0,28,20,8
1915,212,ANCASH,HUAYLAS,202005,20,1,22,30,-8
1917,212,ANCASH,HUAYLAS,202006,57,6,37,19,18
1919,212,ANCASH,HUAYLAS,202007,132,14,49,26,23
1921,212,ANCASH,HUAYLAS,202008,317,15,52,31,21
1923,212,ANCASH,HUAYLAS,202009,253,23,48,20,28
1924,212,ANCASH,HUAYLAS,202010,219,7,25,21,4
1925,212,ANCASH,HUAYLAS,202011,134,1,24,20,4
1926,212,ANCASH,HUAYLAS,202012,23,3,35,28,7
1909,212,ANCASH,HUAYLAS,202101,93,3,24,23,1
1910,212,ANCASH,HUAYLAS,202102,248,13,51,18,33
1912,212,ANCASH,HUAYLAS,202103,333,39,86,23,63
1914,212,ANCASH,HUAYLAS,202104,525,48,75,20,55
1916,212,ANCASH,HUAYLAS,202105,250,17,49,30,19
1918,212,ANCASH,HUAYLAS,202106,176,13,41,19,22
1920,212,ANCASH,HUAYLAS,202107,108,2,31,26,5
1922,212,ANCASH,HUAYLAS,202108,48,3,20,31,-11
1929,213,ANCASH,MARISCAL LUZURIAGA,202003,0,0,7,3,4
1931,213,ANCASH,MARISCAL LUZURIAGA,202004,3,0,7,11,-4
1933,213,ANCASH,MARISCAL LUZURIAGA,202005,13,3,12,10,2
1935,213,ANCASH,MARISCAL LUZURIAGA,202006,17,0,14,14,0
1937,213,ANCASH,MARISCAL LUZURIAGA,202007,11,2,11,7,4
1939,213,ANCASH,MARISCAL LUZURIAGA,202008,22,1,15,10,5
1941,213,ANCASH,MARISCAL LUZURIAGA,202009,39,3,13,8,5
1942,213,ANCASH,MARISCAL LUZURIAGA,202010,20,0,11,13,-2
1943,213,ANCASH,MARISCAL LUZURIAGA,202011,31,1,5,11,-6
1944,213,ANCASH,MARISCAL LUZURIAGA,202012,16,0,5,14,-9
1927,213,ANCASH,MARISCAL LUZURIAGA,202101,7,5,20,17,3
1928,213,ANCASH,MARISCAL LUZURIAGA,202102,7,3,15,10,5
1930,213,ANCASH,MARISCAL LUZURIAGA,202103,16,0,15,3,12
1932,213,ANCASH,MARISCAL LUZURIAGA,202104,71,11,23,11,12
1934,213,ANCASH,MARISCAL LUZURIAGA,202105,64,8,27,10,17
1936,213,ANCASH,MARISCAL LUZURIAGA,202106,14,3,13,14,-1
1938,213,ANCASH,MARISCAL LUZURIAGA,202107,12,3,20,7,13
1940,213,ANCASH,MARISCAL LUZURIAGA,202108,1,1,4,10,-6
1947,214,ANCASH,OCROS,202003,0,0,6,1,5
1949,214,ANCASH,OCROS,202004,0,0,3,4,-1
1951,214,ANCASH,OCROS,202005,2,1,3,1,2
1953,214,ANCASH,OCROS,202006,5,0,4,1,3
1955,214,ANCASH,OCROS,202007,14,5,8,3,5
1957,214,ANCASH,OCROS,202008,28,0,5,0,5
1959,214,ANCASH,OCROS,202009,15,1,2,5,-3
1960,214,ANCASH,OCROS,202010,12,0,5,0,5
1961,214,ANCASH,OCROS,202011,4,1,4,4,0
1962,214,ANCASH,OCROS,202012,3,0,2,3,-1
1945,214,ANCASH,OCROS,202101,9,2,6,1,5
1946,214,ANCASH,OCROS,202102,31,2,3,2,1
1948,214,ANCASH,OCROS,202103,71,2,5,1,4
1950,214,ANCASH,OCROS,202104,49,5,8,4,4
1952,214,ANCASH,OCROS,202105,49,3,6,1,5
1954,214,ANCASH,OCROS,202106,5,0,4,1,3
1956,214,ANCASH,OCROS,202107,0,0,2,3,-1
1958,214,ANCASH,OCROS,202108,3,0,1,0,1
1965,215,ANCASH,PALLASCA,202003,0,0,7,13,-6
1967,215,ANCASH,PALLASCA,202004,0,0,7,12,-5
1969,215,ANCASH,PALLASCA,202005,2,2,17,8,9
1971,215,ANCASH,PALLASCA,202006,16,2,15,6,9
1973,215,ANCASH,PALLASCA,202007,13,1,12,10,2
1975,215,ANCASH,PALLASCA,202008,8,5,14,8,6
1977,215,ANCASH,PALLASCA,202009,26,1,8,11,-3
1978,215,ANCASH,PALLASCA,202010,9,0,12,10,2
1979,215,ANCASH,PALLASCA,202011,7,1,13,11,2
1980,215,ANCASH,PALLASCA,202012,2,1,8,7,1
1963,215,ANCASH,PALLASCA,202101,70,2,18,9,9
1964,215,ANCASH,PALLASCA,202102,40,3,12,11,1
1966,215,ANCASH,PALLASCA,202103,230,11,26,13,13
1968,215,ANCASH,PALLASCA,202104,239,22,44,12,32
1970,215,ANCASH,PALLASCA,202105,90,6,14,8,6
1972,215,ANCASH,PALLASCA,202106,46,3,17,6,11
1974,215,ANCASH,PALLASCA,202107,16,1,10,10,0
1976,215,ANCASH,PALLASCA,202108,8,1,16,8,8
1983,216,ANCASH,POMABAMBA,202003,0,0,14,15,-1
1985,216,ANCASH,POMABAMBA,202004,16,1,8,8,0
1987,216,ANCASH,POMABAMBA,202005,16,0,13,15,-2
1989,216,ANCASH,POMABAMBA,202006,45,3,16,4,12
1991,216,ANCASH,POMABAMBA,202007,40,1,19,9,10
1993,216,ANCASH,POMABAMBA,202008,82,1,16,14,2
1995,216,ANCASH,POMABAMBA,202009,70,6,24,7,17
1996,216,ANCASH,POMABAMBA,202010,53,2,15,13,2
1997,216,ANCASH,POMABAMBA,202011,23,1,5,11,-6
1998,216,ANCASH,POMABAMBA,202012,13,1,5,16,-11
1981,216,ANCASH,POMABAMBA,202101,29,3,21,9,12
1982,216,ANCASH,POMABAMBA,202102,34,7,18,8,10
1984,216,ANCASH,POMABAMBA,202103,80,3,15,15,0
1986,216,ANCASH,POMABAMBA,202104,212,16,45,8,37
1988,216,ANCASH,POMABAMBA,202105,253,11,23,15,8
1990,216,ANCASH,POMABAMBA,202106,172,11,20,4,16
1992,216,ANCASH,POMABAMBA,202107,45,8,15,9,6
1994,216,ANCASH,POMABAMBA,202108,11,1,7,14,-7
2001,217,ANCASH,RECUAY,202003,0,0,4,7,-3
2003,217,ANCASH,RECUAY,202004,3,0,6,10,-4
2005,217,ANCASH,RECUAY,202005,20,1,12,10,2
2007,217,ANCASH,RECUAY,202006,10,3,9,6,3
2009,217,ANCASH,RECUAY,202007,42,2,18,9,9
2011,217,ANCASH,RECUAY,202008,118,5,16,10,6
2013,217,ANCASH,RECUAY,202009,58,5,11,7,4
2014,217,ANCASH,RECUAY,202010,52,2,11,14,-3
2015,217,ANCASH,RECUAY,202011,14,1,12,11,1
2016,217,ANCASH,RECUAY,202012,9,0,7,7,0
1999,217,ANCASH,RECUAY,202101,19,3,12,8,4
2000,217,ANCASH,RECUAY,202102,44,3,17,7,10
2002,217,ANCASH,RECUAY,202103,178,13,31,7,24
2004,217,ANCASH,RECUAY,202104,271,22,30,10,20
2006,217,ANCASH,RECUAY,202105,100,5,12,10,2
2008,217,ANCASH,RECUAY,202106,71,3,10,6,4
2010,217,ANCASH,RECUAY,202107,48,1,16,9,7
2012,217,ANCASH,RECUAY,202108,25,0,8,10,-2
2019,218,ANCASH,SANTA,202003,12,3,230,199,31
2021,218,ANCASH,SANTA,202004,699,106,265,164,101
2023,218,ANCASH,SANTA,202005,3061,437,663,180,483
2025,218,ANCASH,SANTA,202006,2270,454,684,168,516
2027,218,ANCASH,SANTA,202007,2016,347,518,184,334
2029,218,ANCASH,SANTA,202008,2770,220,395,200,195
2031,218,ANCASH,SANTA,202009,2017,106,262,171,91
2032,218,ANCASH,SANTA,202010,1721,67,237,193,44
2033,218,ANCASH,SANTA,202011,1167,62,213,204,9
2034,218,ANCASH,SANTA,202012,1598,105,276,196,80
2017,218,ANCASH,SANTA,202101,4268,280,512,179,333
2018,218,ANCASH,SANTA,202102,3228,247,432,166,266
2020,218,ANCASH,SANTA,202103,3668,270,512,199,313
2022,218,ANCASH,SANTA,202104,5398,556,755,164,591
2024,218,ANCASH,SANTA,202105,2993,462,652,180,472
2026,218,ANCASH,SANTA,202106,965,123,312,168,144
2028,218,ANCASH,SANTA,202107,488,34,217,184,33
2030,218,ANCASH,SANTA,202108,188,17,193,200,-7
2037,219,ANCASH,SIHUAS,202003,0,0,10,15,-5
2039,219,ANCASH,SIHUAS,202004,0,0,14,19,-5
2041,219,ANCASH,SIHUAS,202005,29,1,22,6,16
2043,219,ANCASH,SIHUAS,202006,24,0,16,14,2
2045,219,ANCASH,SIHUAS,202007,25,1,24,13,11
2047,219,ANCASH,SIHUAS,202008,46,3,19,10,9
2049,219,ANCASH,SIHUAS,202009,42,3,11,15,-4
2050,219,ANCASH,SIHUAS,202010,40,3,13,18,-5
2051,219,ANCASH,SIHUAS,202011,31,1,6,18,-12
2052,219,ANCASH,SIHUAS,202012,13,0,8,14,-6
2035,219,ANCASH,SIHUAS,202101,38,4,20,16,4
2036,219,ANCASH,SIHUAS,202102,64,1,11,10,1
2038,219,ANCASH,SIHUAS,202103,188,11,24,15,9
2040,219,ANCASH,SIHUAS,202104,316,17,47,19,28
2042,219,ANCASH,SIHUAS,202105,198,3,22,6,16
2044,219,ANCASH,SIHUAS,202106,137,9,17,14,3
2046,219,ANCASH,SIHUAS,202107,52,4,24,13,11
2048,219,ANCASH,SIHUAS,202108,12,0,5,10,-5
2055,220,ANCASH,YUNGAY,202003,0,0,22,30,-8
2057,220,ANCASH,YUNGAY,202004,3,0,17,23,-6
2059,220,ANCASH,YUNGAY,202005,18,4,19,21,-2
2061,220,ANCASH,YUNGAY,202006,26,4,23,27,-4
2063,220,ANCASH,YUNGAY,202007,55,7,30,28,2
2065,220,ANCASH,YUNGAY,202008,115,11,44,13,31
2067,220,ANCASH,YUNGAY,202009,63,8,39,24,15
2068,220,ANCASH,YUNGAY,202010,86,0,25,30,-5
2069,220,ANCASH,YUNGAY,202011,41,2,27,17,10
2070,220,ANCASH,YUNGAY,202012,25,3,31,26,5
2053,220,ANCASH,YUNGAY,202101,33,4,25,29,-4
2054,220,ANCASH,YUNGAY,202102,85,13,28,27,1
2056,220,ANCASH,YUNGAY,202103,186,4,39,30,9
2058,220,ANCASH,YUNGAY,202104,271,20,55,23,32
2060,220,ANCASH,YUNGAY,202105,211,23,58,21,37
2062,220,ANCASH,YUNGAY,202106,133,5,32,27,5
2064,220,ANCASH,YUNGAY,202107,63,4,32,28,4
2066,220,ANCASH,YUNGAY,202108,29,3,27,13,14
2451,301,APURIMAC,ABANCAY,202003,0,0,31,48,-17
2453,301,APURIMAC,ABANCAY,202004,108,2,40,36,4
2455,301,APURIMAC,ABANCAY,202005,72,2,45,41,4
2457,301,APURIMAC,ABANCAY,202006,134,7,46,42,4
2459,301,APURIMAC,ABANCAY,202007,240,11,49,37,12
2461,301,APURIMAC,ABANCAY,202008,1126,53,78,41,37
2463,301,APURIMAC,ABANCAY,202009,1108,34,70,39,31
2464,301,APURIMAC,ABANCAY,202010,570,22,72,32,40
2465,301,APURIMAC,ABANCAY,202011,332,16,59,46,13
2466,301,APURIMAC,ABANCAY,202012,581,13,60,41,19
2449,301,APURIMAC,ABANCAY,202101,962,57,93,44,49
2450,301,APURIMAC,ABANCAY,202102,724,40,69,29,40
2452,301,APURIMAC,ABANCAY,202103,815,47,96,48,48
2454,301,APURIMAC,ABANCAY,202104,2304,100,139,36,103
2456,301,APURIMAC,ABANCAY,202105,1408,102,142,41,101
2458,301,APURIMAC,ABANCAY,202106,726,34,71,42,29
2460,301,APURIMAC,ABANCAY,202107,300,10,60,37,23
2462,301,APURIMAC,ABANCAY,202108,157,9,48,41,7
2469,302,APURIMAC,ANDAHUAYLAS,202003,0,0,44,43,1
2471,302,APURIMAC,ANDAHUAYLAS,202004,43,0,56,43,13
2473,302,APURIMAC,ANDAHUAYLAS,202005,25,1,57,37,20
2475,302,APURIMAC,ANDAHUAYLAS,202006,83,9,57,39,18
2477,302,APURIMAC,ANDAHUAYLAS,202007,102,12,69,39,30
2479,302,APURIMAC,ANDAHUAYLAS,202008,468,18,78,53,25
2481,302,APURIMAC,ANDAHUAYLAS,202009,401,22,95,39,56
2482,302,APURIMAC,ANDAHUAYLAS,202010,182,11,52,42,10
2483,302,APURIMAC,ANDAHUAYLAS,202011,219,9,63,45,18
2484,302,APURIMAC,ANDAHUAYLAS,202012,301,16,82,56,26
2467,302,APURIMAC,ANDAHUAYLAS,202101,634,39,100,45,55
2468,302,APURIMAC,ANDAHUAYLAS,202102,428,40,103,36,67
2470,302,APURIMAC,ANDAHUAYLAS,202103,1100,59,130,43,87
2472,302,APURIMAC,ANDAHUAYLAS,202104,2278,111,191,43,148
2474,302,APURIMAC,ANDAHUAYLAS,202105,904,90,156,37,119
2476,302,APURIMAC,ANDAHUAYLAS,202106,289,17,92,39,53
2478,302,APURIMAC,ANDAHUAYLAS,202107,162,9,72,39,33
2480,302,APURIMAC,ANDAHUAYLAS,202108,52,2,61,53,8
2487,303,APURIMAC,ANTABAMBA,202003,0,0,2,3,-1
2489,303,APURIMAC,ANTABAMBA,202004,0,1,6,10,-4
2491,303,APURIMAC,ANTABAMBA,202005,2,0,3,10,-7
2493,303,APURIMAC,ANTABAMBA,202006,11,0,4,4,0
2495,303,APURIMAC,ANTABAMBA,202007,4,2,7,6,1
2497,303,APURIMAC,ANTABAMBA,202008,17,0,7,10,-3
2499,303,APURIMAC,ANTABAMBA,202009,25,1,9,3,6
2500,303,APURIMAC,ANTABAMBA,202010,35,0,8,9,-1
2501,303,APURIMAC,ANTABAMBA,202011,9,0,4,4,0
2502,303,APURIMAC,ANTABAMBA,202012,9,2,10,5,5
2485,303,APURIMAC,ANTABAMBA,202101,68,5,25,7,18
2486,303,APURIMAC,ANTABAMBA,202102,58,7,19,4,15
2488,303,APURIMAC,ANTABAMBA,202103,63,4,14,3,11
2490,303,APURIMAC,ANTABAMBA,202104,113,6,11,10,1
2492,303,APURIMAC,ANTABAMBA,202105,123,9,12,10,2
2494,303,APURIMAC,ANTABAMBA,202106,77,3,7,4,3
2496,303,APURIMAC,ANTABAMBA,202107,57,5,10,6,4
2498,303,APURIMAC,ANTABAMBA,202108,5,1,10,10,0
2505,304,APURIMAC,AYMARAES,202003,0,0,15,14,1
2507,304,APURIMAC,AYMARAES,202004,1,0,13,3,10
2509,304,APURIMAC,AYMARAES,202005,6,0,17,15,2
2511,304,APURIMAC,AYMARAES,202006,20,1,14,12,2
2513,304,APURIMAC,AYMARAES,202007,13,3,15,9,6
2515,304,APURIMAC,AYMARAES,202008,62,7,23,17,6
2517,304,APURIMAC,AYMARAES,202009,94,6,26,21,5
2518,304,APURIMAC,AYMARAES,202010,35,4,19,18,1
2519,304,APURIMAC,AYMARAES,202011,47,5,23,20,3
2520,304,APURIMAC,AYMARAES,202012,22,4,22,16,6
2503,304,APURIMAC,AYMARAES,202101,68,10,23,10,13
2504,304,APURIMAC,AYMARAES,202102,74,4,16,5,11
2506,304,APURIMAC,AYMARAES,202103,79,6,20,14,6
2508,304,APURIMAC,AYMARAES,202104,177,9,28,3,25
2510,304,APURIMAC,AYMARAES,202105,207,23,44,15,29
2512,304,APURIMAC,AYMARAES,202106,76,8,27,12,15
2514,304,APURIMAC,AYMARAES,202107,48,2,14,9,5
2516,304,APURIMAC,AYMARAES,202108,7,4,12,17,-5
2523,305,APURIMAC,COTABAMBAS,202003,0,0,19,20,-1
2525,305,APURIMAC,COTABAMBAS,202004,1,0,8,18,-10
2527,305,APURIMAC,COTABAMBAS,202005,9,0,14,13,1
2529,305,APURIMAC,COTABAMBAS,202006,19,0,28,12,16
2531,305,APURIMAC,COTABAMBAS,202007,34,1,19,11,8
2533,305,APURIMAC,COTABAMBAS,202008,227,7,32,18,14
2535,305,APURIMAC,COTABAMBAS,202009,136,6,22,16,6
2536,305,APURIMAC,COTABAMBAS,202010,96,5,22,22,0
2537,305,APURIMAC,COTABAMBAS,202011,36,2,16,22,-6
2538,305,APURIMAC,COTABAMBAS,202012,52,6,35,19,16
2521,305,APURIMAC,COTABAMBAS,202101,101,2,34,29,5
2522,305,APURIMAC,COTABAMBAS,202102,185,10,35,19,16
2524,305,APURIMAC,COTABAMBAS,202103,236,13,47,20,27
2526,305,APURIMAC,COTABAMBAS,202104,289,11,25,18,7
2528,305,APURIMAC,COTABAMBAS,202105,351,21,47,13,34
2530,305,APURIMAC,COTABAMBAS,202106,213,18,42,12,30
2532,305,APURIMAC,COTABAMBAS,202107,119,9,33,11,22
2534,305,APURIMAC,COTABAMBAS,202108,47,0,19,18,1
2541,306,APURIMAC,CHINCHEROS,202003,0,0,5,11,-6
2543,306,APURIMAC,CHINCHEROS,202004,1,1,10,11,-1
2545,306,APURIMAC,CHINCHEROS,202005,12,1,10,11,-1
2547,306,APURIMAC,CHINCHEROS,202006,46,3,15,8,7
2549,306,APURIMAC,CHINCHEROS,202007,16,4,17,13,4
2551,306,APURIMAC,CHINCHEROS,202008,108,3,21,18,3
2553,306,APURIMAC,CHINCHEROS,202009,47,5,15,13,2
2554,306,APURIMAC,CHINCHEROS,202010,40,4,22,14,8
2555,306,APURIMAC,CHINCHEROS,202011,41,5,17,14,3
2556,306,APURIMAC,CHINCHEROS,202012,38,5,18,14,4
2539,306,APURIMAC,CHINCHEROS,202101,102,15,34,18,16
2540,306,APURIMAC,CHINCHEROS,202102,167,8,28,8,20
2542,306,APURIMAC,CHINCHEROS,202103,263,17,43,11,32
2544,306,APURIMAC,CHINCHEROS,202104,514,31,59,11,48
2546,306,APURIMAC,CHINCHEROS,202105,289,29,53,11,42
2548,306,APURIMAC,CHINCHEROS,202106,118,7,26,8,18
2550,306,APURIMAC,CHINCHEROS,202107,45,4,25,13,12
2552,306,APURIMAC,CHINCHEROS,202108,31,1,22,18,4
2559,307,APURIMAC,GRAU,202003,0,0,6,14,-8
2561,307,APURIMAC,GRAU,202004,2,0,6,9,-3
2563,307,APURIMAC,GRAU,202005,3,1,12,6,6
2565,307,APURIMAC,GRAU,202006,15,1,11,11,0
2567,307,APURIMAC,GRAU,202007,2,0,10,9,1
2569,307,APURIMAC,GRAU,202008,29,2,9,6,3
2571,307,APURIMAC,GRAU,202009,30,2,11,10,1
2572,307,APURIMAC,GRAU,202010,7,0,11,11,0
2573,307,APURIMAC,GRAU,202011,4,1,14,9,5
2574,307,APURIMAC,GRAU,202012,35,1,17,5,12
2557,307,APURIMAC,GRAU,202101,87,14,24,10,14
2558,307,APURIMAC,GRAU,202102,35,7,25,9,16
2560,307,APURIMAC,GRAU,202103,36,2,23,14,9
2562,307,APURIMAC,GRAU,202104,110,6,18,9,9
2564,307,APURIMAC,GRAU,202105,81,14,29,6,23
2566,307,APURIMAC,GRAU,202106,36,8,21,11,10
2568,307,APURIMAC,GRAU,202107,13,1,10,9,1
2570,307,APURIMAC,GRAU,202108,6,1,12,6,6
2577,401,AREQUIPA,AREQUIPA,202003,29,1,461,485,-24
2579,401,AREQUIPA,AREQUIPA,202004,711,40,468,459,9
2581,401,AREQUIPA,AREQUIPA,202005,2573,116,545,470,75
2583,401,AREQUIPA,AREQUIPA,202006,3195,532,1058,474,584
2585,401,AREQUIPA,AREQUIPA,202007,7178,1399,2384,524,1860
2587,401,AREQUIPA,AREQUIPA,202008,16501,1026,1598,464,1134
2589,401,AREQUIPA,AREQUIPA,202009,7053,312,645,459,186
2590,401,AREQUIPA,AREQUIPA,202010,2019,133,512,443,69
2591,401,AREQUIPA,AREQUIPA,202011,1030,94,491,422,69
2592,401,AREQUIPA,AREQUIPA,202012,1466,125,558,478,80
2575,401,AREQUIPA,AREQUIPA,202101,4309,335,775,433,342
2576,401,AREQUIPA,AREQUIPA,202102,5152,455,852,388,464
2578,401,AREQUIPA,AREQUIPA,202103,4029,328,810,485,325
2580,401,AREQUIPA,AREQUIPA,202104,5621,430,839,459,380
2582,401,AREQUIPA,AREQUIPA,202105,10741,835,1321,470,851
2584,401,AREQUIPA,AREQUIPA,202106,14728,1162,1769,474,1295
2586,401,AREQUIPA,AREQUIPA,202107,5926,422,936,524,412
2588,401,AREQUIPA,AREQUIPA,202108,1902,97,515,464,51
2595,402,AREQUIPA,CAMANA,202003,0,0,21,18,3
2597,402,AREQUIPA,CAMANA,202004,11,3,25,27,-2
2599,402,AREQUIPA,CAMANA,202005,27,2,25,23,2
2601,402,AREQUIPA,CAMANA,202006,58,3,30,23,7
2603,402,AREQUIPA,CAMANA,202007,136,16,50,31,19
2605,402,AREQUIPA,CAMANA,202008,462,25,63,26,37
2607,402,AREQUIPA,CAMANA,202009,258,12,46,35,11
2608,402,AREQUIPA,CAMANA,202010,106,5,33,25,8
2609,402,AREQUIPA,CAMANA,202011,162,8,28,35,-7
2610,402,AREQUIPA,CAMANA,202012,168,11,35,44,-9
2593,402,AREQUIPA,CAMANA,202101,500,74,130,33,97
2594,402,AREQUIPA,CAMANA,202102,406,85,123,34,89
2596,402,AREQUIPA,CAMANA,202103,162,27,52,18,34
2598,402,AREQUIPA,CAMANA,202104,196,23,45,27,18
2600,402,AREQUIPA,CAMANA,202105,277,37,58,23,35
2602,402,AREQUIPA,CAMANA,202106,300,44,72,23,49
2604,402,AREQUIPA,CAMANA,202107,165,20,54,31,23
2606,402,AREQUIPA,CAMANA,202108,49,4,38,26,12
2613,403,AREQUIPA,CARAVELI,202003,1,0,18,10,8
2615,403,AREQUIPA,CARAVELI,202004,9,1,8,17,-9
2617,403,AREQUIPA,CARAVELI,202005,121,2,9,9,0
2619,403,AREQUIPA,CARAVELI,202006,69,5,9,16,-7
2621,403,AREQUIPA,CARAVELI,202007,51,7,19,9,10
2623,403,AREQUIPA,CARAVELI,202008,144,7,18,18,0
2625,403,AREQUIPA,CARAVELI,202009,161,17,33,10,23
2626,403,AREQUIPA,CARAVELI,202010,111,4,13,12,1
2627,403,AREQUIPA,CARAVELI,202011,52,4,13,8,5
2628,403,AREQUIPA,CARAVELI,202012,50,4,15,6,9
2611,403,AREQUIPA,CARAVELI,202101,129,7,23,10,13
2612,403,AREQUIPA,CARAVELI,202102,357,20,39,16,23
2614,403,AREQUIPA,CARAVELI,202103,357,29,45,10,35
2616,403,AREQUIPA,CARAVELI,202104,327,32,56,17,39
2618,403,AREQUIPA,CARAVELI,202105,334,26,41,9,32
2620,403,AREQUIPA,CARAVELI,202106,193,27,44,16,28
2622,403,AREQUIPA,CARAVELI,202107,125,9,24,9,15
2624,403,AREQUIPA,CARAVELI,202108,33,3,16,18,-2
2631,404,AREQUIPA,CASTILLA,202003,0,0,18,13,5
2633,404,AREQUIPA,CASTILLA,202004,3,0,6,19,-13
2635,404,AREQUIPA,CASTILLA,202005,16,1,9,11,-2
2637,404,AREQUIPA,CASTILLA,202006,32,2,16,17,-1
2639,404,AREQUIPA,CASTILLA,202007,66,9,19,13,6
2641,404,AREQUIPA,CASTILLA,202008,153,11,34,12,22
2643,404,AREQUIPA,CASTILLA,202009,134,1,18,19,-1
2644,404,AREQUIPA,CASTILLA,202010,65,3,17,5,12
2645,404,AREQUIPA,CASTILLA,202011,53,4,20,14,6
2646,404,AREQUIPA,CASTILLA,202012,39,2,13,16,-3
2629,404,AREQUIPA,CASTILLA,202101,154,9,25,10,15
2630,404,AREQUIPA,CASTILLA,202102,161,10,29,13,16
2632,404,AREQUIPA,CASTILLA,202103,141,8,26,13,13
2634,404,AREQUIPA,CASTILLA,202104,241,18,31,19,12
2636,404,AREQUIPA,CASTILLA,202105,362,37,50,11,39
2638,404,AREQUIPA,CASTILLA,202106,442,26,42,17,25
2640,404,AREQUIPA,CASTILLA,202107,187,8,23,13,10
2642,404,AREQUIPA,CASTILLA,202108,58,0,18,12,6
2649,405,AREQUIPA,CAYLLOMA,202003,0,1,22,18,4
2651,405,AREQUIPA,CAYLLOMA,202004,24,1,32,24,8
2653,405,AREQUIPA,CAYLLOMA,202005,45,2,35,19,16
2655,405,AREQUIPA,CAYLLOMA,202006,93,10,43,28,15
2657,405,AREQUIPA,CAYLLOMA,202007,332,37,76,26,50
2659,405,AREQUIPA,CAYLLOMA,202008,668,62,89,22,67
2661,405,AREQUIPA,CAYLLOMA,202009,378,21,45,16,29
2662,405,AREQUIPA,CAYLLOMA,202010,104,11,38,17,21
2663,405,AREQUIPA,CAYLLOMA,202011,71,4,30,22,8
2664,405,AREQUIPA,CAYLLOMA,202012,78,3,39,30,9
2647,405,AREQUIPA,CAYLLOMA,202101,195,19,55,21,34
2648,405,AREQUIPA,CAYLLOMA,202102,404,40,66,24,42
2650,405,AREQUIPA,CAYLLOMA,202103,304,36,56,18,38
2652,405,AREQUIPA,CAYLLOMA,202104,399,36,71,24,47
2654,405,AREQUIPA,CAYLLOMA,202105,828,73,108,19,89
2656,405,AREQUIPA,CAYLLOMA,202106,782,82,123,28,95
2658,405,AREQUIPA,CAYLLOMA,202107,347,22,51,26,25
2660,405,AREQUIPA,CAYLLOMA,202108,122,10,42,22,20
2667,406,AREQUIPA,CONDESUYOS,202003,0,0,6,7,-1
2669,406,AREQUIPA,CONDESUYOS,202004,0,1,8,6,2
2671,406,AREQUIPA,CONDESUYOS,202005,2,0,4,7,-3
2673,406,AREQUIPA,CONDESUYOS,202006,4,0,6,4,2
2675,406,AREQUIPA,CONDESUYOS,202007,17,3,13,6,7
2677,406,AREQUIPA,CONDESUYOS,202008,50,3,8,6,2
2679,406,AREQUIPA,CONDESUYOS,202009,32,2,9,9,0
2680,406,AREQUIPA,CONDESUYOS,202010,99,3,12,9,3
2681,406,AREQUIPA,CONDESUYOS,202011,38,0,4,10,-6
2682,406,AREQUIPA,CONDESUYOS,202012,31,2,5,7,-2
2665,406,AREQUIPA,CONDESUYOS,202101,91,3,13,4,9
2666,406,AREQUIPA,CONDESUYOS,202102,83,4,13,2,11
2668,406,AREQUIPA,CONDESUYOS,202103,65,4,9,7,2
2670,406,AREQUIPA,CONDESUYOS,202104,60,2,6,6,0
2672,406,AREQUIPA,CONDESUYOS,202105,147,17,21,7,14
2674,406,AREQUIPA,CONDESUYOS,202106,150,8,18,4,14
2676,406,AREQUIPA,CONDESUYOS,202107,77,8,15,6,9
2678,406,AREQUIPA,CONDESUYOS,202108,12,1,11,6,5
2685,407,AREQUIPA,ISLAY,202003,0,0,12,31,-19
2687,407,AREQUIPA,ISLAY,202004,44,2,21,14,7
2689,407,AREQUIPA,ISLAY,202005,62,3,22,27,-5
2691,407,AREQUIPA,ISLAY,202006,74,7,35,27,8
2693,407,AREQUIPA,ISLAY,202007,288,44,84,41,43
2695,407,AREQUIPA,ISLAY,202008,804,45,83,29,54
2697,407,AREQUIPA,ISLAY,202009,381,14,37,28,9
2698,407,AREQUIPA,ISLAY,202010,52,12,31,32,-1
2699,407,AREQUIPA,ISLAY,202011,40,6,29,32,-3
2700,407,AREQUIPA,ISLAY,202012,37,7,33,22,11
2683,407,AREQUIPA,ISLAY,202101,265,32,62,19,43
2684,407,AREQUIPA,ISLAY,202102,205,38,74,26,48
2686,407,AREQUIPA,ISLAY,202103,210,25,58,31,27
2688,407,AREQUIPA,ISLAY,202104,246,23,52,14,38
2690,407,AREQUIPA,ISLAY,202105,419,66,91,27,64
2692,407,AREQUIPA,ISLAY,202106,312,70,101,27,74
2694,407,AREQUIPA,ISLAY,202107,160,29,59,41,18
2696,407,AREQUIPA,ISLAY,202108,56,6,30,29,1
2703,408,AREQUIPA,LA UNIÒN,202003,0,0,9,8,1
2705,408,AREQUIPA,LA UNIÒN,202004,0,0,8,6,2
2707,408,AREQUIPA,LA UNIÒN,202005,5,0,8,5,3
2709,408,AREQUIPA,LA UNIÒN,202006,3,0,11,7,4
2711,408,AREQUIPA,LA UNIÒN,202007,10,0,6,9,-3
2713,408,AREQUIPA,LA UNIÒN,202008,21,3,8,6,2
2715,408,AREQUIPA,LA UNIÒN,202009,13,0,3,10,-7
2716,408,AREQUIPA,LA UNIÒN,202010,4,0,2,11,-9
2717,408,AREQUIPA,LA UNIÒN,202011,0,1,3,8,-5
2718,408,AREQUIPA,LA UNIÒN,202012,3,0,5,12,-7
2701,408,AREQUIPA,LA UNIÒN,202101,24,3,12,6,6
2702,408,AREQUIPA,LA UNIÒN,202102,43,3,18,5,13
2704,408,AREQUIPA,LA UNIÒN,202103,48,3,20,8,12
2706,408,AREQUIPA,LA UNIÒN,202104,100,4,14,6,8
2708,408,AREQUIPA,LA UNIÒN,202105,111,6,11,5,6
2710,408,AREQUIPA,LA UNIÒN,202106,74,7,18,7,11
2712,408,AREQUIPA,LA UNIÒN,202107,45,5,15,9,6
2714,408,AREQUIPA,LA UNIÒN,202108,10,3,6,6,0
2721,501,AYACUCHO,HUAMANGA,202003,1,1,50,72,-22
2723,501,AYACUCHO,HUAMANGA,202004,110,0,46,99,-53
2725,501,AYACUCHO,HUAMANGA,202005,518,16,64,70,-6
2727,501,AYACUCHO,HUAMANGA,202006,839,42,68,76,-8
2729,501,AYACUCHO,HUAMANGA,202007,1929,129,121,84,37
2731,501,AYACUCHO,HUAMANGA,202008,3133,224,180,81,99
2733,501,AYACUCHO,HUAMANGA,202009,1886,74,109,78,31
2734,501,AYACUCHO,HUAMANGA,202010,746,27,95,79,16
2735,501,AYACUCHO,HUAMANGA,202011,496,9,79,86,-7
2736,501,AYACUCHO,HUAMANGA,202012,386,11,128,86,42
2719,501,AYACUCHO,HUAMANGA,202101,1109,41,154,101,53
2720,501,AYACUCHO,HUAMANGA,202102,1467,98,178,74,104
2722,501,AYACUCHO,HUAMANGA,202103,1862,151,264,72,192
2724,501,AYACUCHO,HUAMANGA,202104,1500,99,193,99,94
2726,501,AYACUCHO,HUAMANGA,202105,1243,122,206,70,136
2728,501,AYACUCHO,HUAMANGA,202106,753,47,152,76,76
2730,501,AYACUCHO,HUAMANGA,202107,502,28,132,84,48
2732,501,AYACUCHO,HUAMANGA,202108,478,15,102,81,21
2739,502,AYACUCHO,CANGALLO,202003,0,0,9,10,-1
2741,502,AYACUCHO,CANGALLO,202004,2,0,8,13,-5
2743,502,AYACUCHO,CANGALLO,202005,6,2,17,19,-2
2745,502,AYACUCHO,CANGALLO,202006,22,3,20,6,14
2747,502,AYACUCHO,CANGALLO,202007,32,5,11,13,-2
2749,502,AYACUCHO,CANGALLO,202008,48,1,19,14,5
2751,502,AYACUCHO,CANGALLO,202009,68,3,19,13,6
2752,502,AYACUCHO,CANGALLO,202010,24,3,15,8,7
2753,502,AYACUCHO,CANGALLO,202011,17,4,19,13,6
2754,502,AYACUCHO,CANGALLO,202012,9,2,15,18,-3
2737,502,AYACUCHO,CANGALLO,202101,40,4,14,7,7
2738,502,AYACUCHO,CANGALLO,202102,94,9,30,17,13
2740,502,AYACUCHO,CANGALLO,202103,140,17,47,10,37
2742,502,AYACUCHO,CANGALLO,202104,109,8,29,13,16
2744,502,AYACUCHO,CANGALLO,202105,107,5,23,19,4
2746,502,AYACUCHO,CANGALLO,202106,61,3,18,6,12
2748,502,AYACUCHO,CANGALLO,202107,29,0,13,13,0
2750,502,AYACUCHO,CANGALLO,202108,26,2,16,14,2
2757,503,AYACUCHO,HUANCA SANCOS,202003,0,0,3,2,1
2759,503,AYACUCHO,HUANCA SANCOS,202004,0,0,1,3,-2
2761,503,AYACUCHO,HUANCA SANCOS,202005,1,0,4,2,2
2763,503,AYACUCHO,HUANCA SANCOS,202006,7,1,1,0,1
2765,503,AYACUCHO,HUANCA SANCOS,202007,1,0,5,1,4
2767,503,AYACUCHO,HUANCA SANCOS,202008,31,0,4,1,3
2769,503,AYACUCHO,HUANCA SANCOS,202009,15,2,2,0,2
2770,503,AYACUCHO,HUANCA SANCOS,202010,11,0,2,3,-1
2771,503,AYACUCHO,HUANCA SANCOS,202011,4,0,8,0,8
2772,503,AYACUCHO,HUANCA SANCOS,202012,7,0,6,1,5
2755,503,AYACUCHO,HUANCA SANCOS,202101,5,1,7,2,5
2756,503,AYACUCHO,HUANCA SANCOS,202102,34,2,10,4,6
2758,503,AYACUCHO,HUANCA SANCOS,202103,19,2,6,2,4
2760,503,AYACUCHO,HUANCA SANCOS,202104,31,3,9,3,6
2762,503,AYACUCHO,HUANCA SANCOS,202105,49,2,9,2,7
2764,503,AYACUCHO,HUANCA SANCOS,202106,22,3,7,0,7
2766,503,AYACUCHO,HUANCA SANCOS,202107,22,0,4,1,3
2768,503,AYACUCHO,HUANCA SANCOS,202108,2,0,3,1,2
2775,504,AYACUCHO,HUANTA,202003,0,0,17,11,6
2777,504,AYACUCHO,HUANTA,202004,8,1,16,9,7
2779,504,AYACUCHO,HUANTA,202005,32,2,12,11,1
2781,504,AYACUCHO,HUANTA,202006,33,2,19,7,12
2783,504,AYACUCHO,HUANTA,202007,207,14,20,11,9
2785,504,AYACUCHO,HUANTA,202008,609,34,43,4,39
2787,504,AYACUCHO,HUANTA,202009,477,23,33,17,16
2788,504,AYACUCHO,HUANTA,202010,398,14,20,10,10
2789,504,AYACUCHO,HUANTA,202011,150,7,21,18,3
2790,504,AYACUCHO,HUANTA,202012,41,3,27,12,15
2773,504,AYACUCHO,HUANTA,202101,95,7,25,17,8
2774,504,AYACUCHO,HUANTA,202102,234,13,32,15,17
2776,504,AYACUCHO,HUANTA,202103,543,40,68,11,57
2778,504,AYACUCHO,HUANTA,202104,611,45,65,9,56
2780,504,AYACUCHO,HUANTA,202105,321,46,65,11,54
2782,504,AYACUCHO,HUANTA,202106,126,14,29,7,22
2784,504,AYACUCHO,HUANTA,202107,72,5,24,11,13
2786,504,AYACUCHO,HUANTA,202108,46,2,37,4,33
2793,505,AYACUCHO,LA MAR,202003,0,0,22,25,-3
2795,505,AYACUCHO,LA MAR,202004,0,0,22,24,-2
2797,505,AYACUCHO,LA MAR,202005,39,1,26,19,7
2799,505,AYACUCHO,LA MAR,202006,38,4,21,28,-7
2801,505,AYACUCHO,LA MAR,202007,51,5,28,14,14
2803,505,AYACUCHO,LA MAR,202008,230,23,26,24,2
2805,505,AYACUCHO,LA MAR,202009,203,10,28,25,3
2806,505,AYACUCHO,LA MAR,202010,186,9,28,14,14
2807,505,AYACUCHO,LA MAR,202011,87,3,27,20,7
2808,505,AYACUCHO,LA MAR,202012,105,3,32,22,10
2791,505,AYACUCHO,LA MAR,202101,129,6,22,22,0
2792,505,AYACUCHO,LA MAR,202102,204,14,34,11,23
2794,505,AYACUCHO,LA MAR,202103,362,22,53,25,28
2796,505,AYACUCHO,LA MAR,202104,278,28,59,24,35
2798,505,AYACUCHO,LA MAR,202105,173,11,38,19,19
2800,505,AYACUCHO,LA MAR,202106,55,4,20,28,-8
2802,505,AYACUCHO,LA MAR,202107,57,5,31,14,17
2804,505,AYACUCHO,LA MAR,202108,121,1,20,24,-4
2811,506,AYACUCHO,LUCANAS,202003,0,0,9,19,-10
2813,506,AYACUCHO,LUCANAS,202004,19,2,17,22,-5
2815,506,AYACUCHO,LUCANAS,202005,26,3,16,23,-7
2817,506,AYACUCHO,LUCANAS,202006,37,4,12,21,-9
2819,506,AYACUCHO,LUCANAS,202007,69,11,29,15,14
2821,506,AYACUCHO,LUCANAS,202008,240,10,30,14,16
2823,506,AYACUCHO,LUCANAS,202009,188,6,23,12,11
2824,506,AYACUCHO,LUCANAS,202010,74,3,9,11,-2
2825,506,AYACUCHO,LUCANAS,202011,54,1,8,19,-11
2826,506,AYACUCHO,LUCANAS,202012,64,7,28,16,12
2809,506,AYACUCHO,LUCANAS,202101,98,8,23,17,6
2810,506,AYACUCHO,LUCANAS,202102,160,19,37,19,18
2812,506,AYACUCHO,LUCANAS,202103,156,17,40,19,21
2814,506,AYACUCHO,LUCANAS,202104,147,15,24,22,2
2816,506,AYACUCHO,LUCANAS,202105,174,15,35,23,12
2818,506,AYACUCHO,LUCANAS,202106,181,26,37,21,16
2820,506,AYACUCHO,LUCANAS,202107,119,13,32,15,17
2822,506,AYACUCHO,LUCANAS,202108,69,3,25,14,11
2829,507,AYACUCHO,PARINACOCHAS,202003,0,0,3,8,-5
2831,507,AYACUCHO,PARINACOCHAS,202004,7,1,4,8,-4
2833,507,AYACUCHO,PARINACOCHAS,202005,35,4,12,10,2
2835,507,AYACUCHO,PARINACOCHAS,202006,43,2,9,10,-1
2837,507,AYACUCHO,PARINACOCHAS,202007,23,6,9,9,0
2839,507,AYACUCHO,PARINACOCHAS,202008,159,4,8,8,0
2841,507,AYACUCHO,PARINACOCHAS,202009,151,4,8,3,5
2842,507,AYACUCHO,PARINACOCHAS,202010,213,2,4,9,-5
2843,507,AYACUCHO,PARINACOCHAS,202011,82,1,8,11,-3
2844,507,AYACUCHO,PARINACOCHAS,202012,50,2,15,10,5
2827,507,AYACUCHO,PARINACOCHAS,202101,55,4,19,8,11
2828,507,AYACUCHO,PARINACOCHAS,202102,131,6,23,8,15
2830,507,AYACUCHO,PARINACOCHAS,202103,206,21,31,8,23
2832,507,AYACUCHO,PARINACOCHAS,202104,201,19,39,8,31
2834,507,AYACUCHO,PARINACOCHAS,202105,187,16,27,10,17
2836,507,AYACUCHO,PARINACOCHAS,202106,93,10,22,10,12
2838,507,AYACUCHO,PARINACOCHAS,202107,117,8,17,9,8
2840,507,AYACUCHO,PARINACOCHAS,202108,39,4,15,8,7
2847,508,AYACUCHO,PÀUCAR DEL SARA SARA,202003,0,0,5,6,-1
2849,508,AYACUCHO,PÀUCAR DEL SARA SARA,202004,0,1,1,8,-7
2851,508,AYACUCHO,PÀUCAR DEL SARA SARA,202005,7,2,3,4,-1
2853,508,AYACUCHO,PÀUCAR DEL SARA SARA,202006,0,1,2,3,-1
2855,508,AYACUCHO,PÀUCAR DEL SARA SARA,202007,6,1,6,4,2
2857,508,AYACUCHO,PÀUCAR DEL SARA SARA,202008,26,1,4,4,0
2859,508,AYACUCHO,PÀUCAR DEL SARA SARA,202009,30,1,2,6,-4
2860,508,AYACUCHO,PÀUCAR DEL SARA SARA,202010,60,1,4,6,-2
2861,508,AYACUCHO,PÀUCAR DEL SARA SARA,202011,16,3,3,3,0
2862,508,AYACUCHO,PÀUCAR DEL SARA SARA,202012,46,2,4,1,3
2845,508,AYACUCHO,PÀUCAR DEL SARA SARA,202101,16,0,3,7,-4
2846,508,AYACUCHO,PÀUCAR DEL SARA SARA,202102,53,3,9,2,7
2848,508,AYACUCHO,PÀUCAR DEL SARA SARA,202103,66,5,9,6,3
2850,508,AYACUCHO,PÀUCAR DEL SARA SARA,202104,87,6,8,8,0
2852,508,AYACUCHO,PÀUCAR DEL SARA SARA,202105,109,10,13,4,9
2854,508,AYACUCHO,PÀUCAR DEL SARA SARA,202106,126,4,6,3,3
2856,508,AYACUCHO,PÀUCAR DEL SARA SARA,202107,85,0,3,4,-1
2858,508,AYACUCHO,PÀUCAR DEL SARA SARA,202108,150,2,4,4,0
2865,509,AYACUCHO,SUCRE,202003,0,0,2,2,0
2867,509,AYACUCHO,SUCRE,202004,0,1,9,3,6
2869,509,AYACUCHO,SUCRE,202005,1,2,10,4,6
2871,509,AYACUCHO,SUCRE,202006,1,0,7,5,2
2873,509,AYACUCHO,SUCRE,202007,4,2,4,5,-1
2875,509,AYACUCHO,SUCRE,202008,14,1,2,11,-9
2877,509,AYACUCHO,SUCRE,202009,4,0,6,4,2
2878,509,AYACUCHO,SUCRE,202010,7,1,8,4,4
2879,509,AYACUCHO,SUCRE,202011,2,1,6,7,-1
2880,509,AYACUCHO,SUCRE,202012,3,0,6,4,2
2863,509,AYACUCHO,SUCRE,202101,12,1,6,3,3
2864,509,AYACUCHO,SUCRE,202102,29,2,8,7,1
2866,509,AYACUCHO,SUCRE,202103,143,7,20,2,18
2868,509,AYACUCHO,SUCRE,202104,80,3,7,3,4
2870,509,AYACUCHO,SUCRE,202105,112,4,10,4,6
2872,509,AYACUCHO,SUCRE,202106,83,3,8,5,3
2874,509,AYACUCHO,SUCRE,202107,165,0,6,5,1
2876,509,AYACUCHO,SUCRE,202108,20,2,6,11,-5
2883,510,AYACUCHO,VICTOR FAJARDO,202003,0,0,6,8,-2
2885,510,AYACUCHO,VICTOR FAJARDO,202004,4,1,8,8,0
2887,510,AYACUCHO,VICTOR FAJARDO,202005,21,2,11,12,-1
2889,510,AYACUCHO,VICTOR FAJARDO,202006,9,3,14,12,2
2891,510,AYACUCHO,VICTOR FAJARDO,202007,10,1,18,7,11
2893,510,AYACUCHO,VICTOR FAJARDO,202008,56,5,17,10,7
2895,510,AYACUCHO,VICTOR FAJARDO,202009,54,1,15,17,-2
2896,510,AYACUCHO,VICTOR FAJARDO,202010,17,5,16,16,0
2897,510,AYACUCHO,VICTOR FAJARDO,202011,23,2,14,10,4
2898,510,AYACUCHO,VICTOR FAJARDO,202012,3,1,11,12,-1
2881,510,AYACUCHO,VICTOR FAJARDO,202101,18,0,11,8,3
2882,510,AYACUCHO,VICTOR FAJARDO,202102,44,7,15,6,9
2884,510,AYACUCHO,VICTOR FAJARDO,202103,63,4,29,8,21
2886,510,AYACUCHO,VICTOR FAJARDO,202104,63,9,36,8,28
2888,510,AYACUCHO,VICTOR FAJARDO,202105,52,7,20,12,8
2890,510,AYACUCHO,VICTOR FAJARDO,202106,41,2,10,12,-2
2892,510,AYACUCHO,VICTOR FAJARDO,202107,18,2,18,7,11
2894,510,AYACUCHO,VICTOR FAJARDO,202108,12,2,9,10,-1
2901,511,AYACUCHO,VILCAS HUAMAN,202003,0,0,11,3,8
2903,511,AYACUCHO,VILCAS HUAMAN,202004,1,0,7,9,-2
2905,511,AYACUCHO,VILCAS HUAMAN,202005,4,0,11,10,1
2907,511,AYACUCHO,VILCAS HUAMAN,202006,15,1,10,7,3
2909,511,AYACUCHO,VILCAS HUAMAN,202007,5,0,7,10,-3
2911,511,AYACUCHO,VILCAS HUAMAN,202008,16,0,10,9,1
2913,511,AYACUCHO,VILCAS HUAMAN,202009,24,2,8,13,-5
2914,511,AYACUCHO,VILCAS HUAMAN,202010,14,0,8,13,-5
2915,511,AYACUCHO,VILCAS HUAMAN,202011,7,1,7,5,2
2916,511,AYACUCHO,VILCAS HUAMAN,202012,6,0,14,13,1
2899,511,AYACUCHO,VILCAS HUAMAN,202101,19,2,19,10,9
2900,511,AYACUCHO,VILCAS HUAMAN,202102,41,14,23,9,14
2902,511,AYACUCHO,VILCAS HUAMAN,202103,52,7,25,3,22
2904,511,AYACUCHO,VILCAS HUAMAN,202104,70,5,19,9,10
2906,511,AYACUCHO,VILCAS HUAMAN,202105,39,3,21,10,11
2908,511,AYACUCHO,VILCAS HUAMAN,202106,32,0,5,7,-2
2910,511,AYACUCHO,VILCAS HUAMAN,202107,13,0,6,10,-4
2912,511,AYACUCHO,VILCAS HUAMAN,202108,5,0,4,9,-5
2919,601,CAJAMARCA,CAJAMARCA,202003,1,0,109,70,39
2921,601,CAJAMARCA,CAJAMARCA,202004,110,3,82,62,20
2923,601,CAJAMARCA,CAJAMARCA,202005,193,8,107,63,44
2925,601,CAJAMARCA,CAJAMARCA,202006,465,36,143,60,83
2927,601,CAJAMARCA,CAJAMARCA,202007,1895,274,381,74,307
2929,601,CAJAMARCA,CAJAMARCA,202008,3594,205,316,81,235
2931,601,CAJAMARCA,CAJAMARCA,202009,1732,65,187,70,117
2932,601,CAJAMARCA,CAJAMARCA,202010,500,33,125,83,42
2933,601,CAJAMARCA,CAJAMARCA,202011,424,18,105,77,28
2934,601,CAJAMARCA,CAJAMARCA,202012,363,26,125,70,55
2917,601,CAJAMARCA,CAJAMARCA,202101,1221,33,142,84,58
2918,601,CAJAMARCA,CAJAMARCA,202102,1871,71,193,68,125
2920,601,CAJAMARCA,CAJAMARCA,202103,4138,209,371,70,301
2922,601,CAJAMARCA,CAJAMARCA,202104,3544,299,453,62,391
2924,601,CAJAMARCA,CAJAMARCA,202105,1765,174,294,63,231
2926,601,CAJAMARCA,CAJAMARCA,202106,815,38,161,60,101
2928,601,CAJAMARCA,CAJAMARCA,202107,391,23,141,74,67
2930,601,CAJAMARCA,CAJAMARCA,202108,414,12,124,81,43
2937,602,CAJAMARCA,CAJABAMBA,202003,0,0,20,30,-10
2939,602,CAJAMARCA,CAJABAMBA,202004,2,3,20,25,-5
2941,602,CAJAMARCA,CAJABAMBA,202005,5,1,27,17,10
2943,602,CAJAMARCA,CAJABAMBA,202006,49,2,34,38,-4
2945,602,CAJAMARCA,CAJABAMBA,202007,80,8,33,39,-6
2947,602,CAJAMARCA,CAJABAMBA,202008,157,18,50,21,29
2949,602,CAJAMARCA,CAJABAMBA,202009,118,12,42,16,26
2950,602,CAJAMARCA,CAJABAMBA,202010,123,9,26,34,-8
2951,602,CAJAMARCA,CAJABAMBA,202011,55,3,24,29,-5
2952,602,CAJAMARCA,CAJABAMBA,202012,55,4,30,29,1
2935,602,CAJAMARCA,CAJABAMBA,202101,62,3,32,30,2
2936,602,CAJAMARCA,CAJABAMBA,202102,156,8,47,27,20
2938,602,CAJAMARCA,CAJABAMBA,202103,321,28,67,30,37
2940,602,CAJAMARCA,CAJABAMBA,202104,461,34,72,25,47
2942,602,CAJAMARCA,CAJABAMBA,202105,343,34,61,17,44
2944,602,CAJAMARCA,CAJABAMBA,202106,193,11,38,38,0
2946,602,CAJAMARCA,CAJABAMBA,202107,92,8,44,39,5
2948,602,CAJAMARCA,CAJABAMBA,202108,16,6,30,21,9
2955,603,CAJAMARCA,CELENDIN,202003,0,0,22,17,5
2957,603,CAJAMARCA,CELENDIN,202004,6,0,24,28,-4
2959,603,CAJAMARCA,CELENDIN,202005,31,1,22,19,3
2961,603,CAJAMARCA,CELENDIN,202006,26,4,26,23,3
2963,603,CAJAMARCA,CELENDIN,202007,72,3,14,24,-10
2965,603,CAJAMARCA,CELENDIN,202008,87,0,18,25,-7
2967,603,CAJAMARCA,CELENDIN,202009,114,17,45,24,21
2968,603,CAJAMARCA,CELENDIN,202010,25,7,33,21,12
2969,603,CAJAMARCA,CELENDIN,202011,31,7,31,24,7
2970,603,CAJAMARCA,CELENDIN,202012,34,10,39,27,12
2953,603,CAJAMARCA,CELENDIN,202101,166,8,45,21,24
2954,603,CAJAMARCA,CELENDIN,202102,189,6,34,15,19
2956,603,CAJAMARCA,CELENDIN,202103,282,12,46,17,29
2958,603,CAJAMARCA,CELENDIN,202104,379,47,85,28,57
2960,603,CAJAMARCA,CELENDIN,202105,142,49,80,19,61
2962,603,CAJAMARCA,CELENDIN,202106,38,9,28,23,5
2964,603,CAJAMARCA,CELENDIN,202107,31,4,34,24,10
2966,603,CAJAMARCA,CELENDIN,202108,16,3,40,25,15
2973,604,CAJAMARCA,CHOTA,202003,0,0,22,37,-15
2975,604,CAJAMARCA,CHOTA,202004,28,2,20,37,-17
2977,604,CAJAMARCA,CHOTA,202005,15,3,26,33,-7
2979,604,CAJAMARCA,CHOTA,202006,73,9,31,33,-2
2981,604,CAJAMARCA,CHOTA,202007,90,2,33,24,9
2983,604,CAJAMARCA,CHOTA,202008,312,13,37,14,23
2985,604,CAJAMARCA,CHOTA,202009,188,18,37,24,13
2986,604,CAJAMARCA,CHOTA,202010,125,5,25,23,2
2987,604,CAJAMARCA,CHOTA,202011,87,4,22,17,5
2988,604,CAJAMARCA,CHOTA,202012,86,5,25,33,-8
2971,604,CAJAMARCA,CHOTA,202101,274,21,44,38,6
2972,604,CAJAMARCA,CHOTA,202102,320,24,51,32,19
2974,604,CAJAMARCA,CHOTA,202103,339,29,53,37,16
2976,604,CAJAMARCA,CHOTA,202104,790,44,72,37,35
2978,604,CAJAMARCA,CHOTA,202105,651,39,74,33,41
2980,604,CAJAMARCA,CHOTA,202106,427,18,47,33,14
2982,604,CAJAMARCA,CHOTA,202107,208,19,51,24,27
2984,604,CAJAMARCA,CHOTA,202108,63,8,39,14,25
2991,605,CAJAMARCA,CONTUMAZA,202003,0,0,7,7,0
2993,605,CAJAMARCA,CONTUMAZA,202004,4,0,7,11,-4
2995,605,CAJAMARCA,CONTUMAZA,202005,9,1,5,5,0
2997,605,CAJAMARCA,CONTUMAZA,202006,19,3,6,5,1
2999,605,CAJAMARCA,CONTUMAZA,202007,27,6,21,6,15
3001,605,CAJAMARCA,CONTUMAZA,202008,93,6,12,3,9
3003,605,CAJAMARCA,CONTUMAZA,202009,29,2,12,7,5
3004,605,CAJAMARCA,CONTUMAZA,202010,21,2,10,10,0
3005,605,CAJAMARCA,CONTUMAZA,202011,8,3,12,8,4
3006,605,CAJAMARCA,CONTUMAZA,202012,13,0,8,8,0
2989,605,CAJAMARCA,CONTUMAZA,202101,29,1,13,7,6
2990,605,CAJAMARCA,CONTUMAZA,202102,141,13,20,10,10
2992,605,CAJAMARCA,CONTUMAZA,202103,386,18,25,7,18
2994,605,CAJAMARCA,CONTUMAZA,202104,240,22,29,11,18
2996,605,CAJAMARCA,CONTUMAZA,202105,108,9,19,5,14
2998,605,CAJAMARCA,CONTUMAZA,202106,36,3,10,5,5
3000,605,CAJAMARCA,CONTUMAZA,202107,17,0,10,6,4
3002,605,CAJAMARCA,CONTUMAZA,202108,33,0,10,3,7
3009,606,CAJAMARCA,CUTERVO,202003,0,0,19,33,-14
3011,606,CAJAMARCA,CUTERVO,202004,3,1,17,24,-7
3013,606,CAJAMARCA,CUTERVO,202005,12,3,15,30,-15
3015,606,CAJAMARCA,CUTERVO,202006,74,7,20,24,-4
3017,606,CAJAMARCA,CUTERVO,202007,58,11,34,30,4
3019,606,CAJAMARCA,CUTERVO,202008,210,17,38,32,6
3021,606,CAJAMARCA,CUTERVO,202009,155,8,32,21,11
3022,606,CAJAMARCA,CUTERVO,202010,136,3,20,34,-14
3023,606,CAJAMARCA,CUTERVO,202011,106,3,24,16,8
3024,606,CAJAMARCA,CUTERVO,202012,121,5,24,25,-1
3007,606,CAJAMARCA,CUTERVO,202101,372,17,54,31,23
3008,606,CAJAMARCA,CUTERVO,202102,287,15,51,23,28
3010,606,CAJAMARCA,CUTERVO,202103,235,12,32,33,-1
3012,606,CAJAMARCA,CUTERVO,202104,736,46,71,24,47
3014,606,CAJAMARCA,CUTERVO,202105,447,39,63,30,33
3016,606,CAJAMARCA,CUTERVO,202106,156,11,34,24,10
3018,606,CAJAMARCA,CUTERVO,202107,68,3,23,30,-7
3020,606,CAJAMARCA,CUTERVO,202108,48,3,22,32,-10
3027,607,CAJAMARCA,HUALGAYOC,202003,0,0,15,26,-11
3029,607,CAJAMARCA,HUALGAYOC,202004,27,1,11,16,-5
3031,607,CAJAMARCA,HUALGAYOC,202005,30,1,10,22,-12
3033,607,CAJAMARCA,HUALGAYOC,202006,39,2,12,12,0
3035,607,CAJAMARCA,HUALGAYOC,202007,110,21,20,21,-1
3037,607,CAJAMARCA,HUALGAYOC,202008,461,14,11,14,-3
3039,607,CAJAMARCA,HUALGAYOC,202009,203,6,18,8,10
3040,607,CAJAMARCA,HUALGAYOC,202010,130,4,20,10,10
3041,607,CAJAMARCA,HUALGAYOC,202011,94,0,9,8,1
3042,607,CAJAMARCA,HUALGAYOC,202012,97,6,6,19,-13
3025,607,CAJAMARCA,HUALGAYOC,202101,157,8,20,25,-5
3026,607,CAJAMARCA,HUALGAYOC,202102,217,10,25,29,-4
3028,607,CAJAMARCA,HUALGAYOC,202103,366,21,38,26,12
3030,607,CAJAMARCA,HUALGAYOC,202104,489,39,68,16,52
3032,607,CAJAMARCA,HUALGAYOC,202105,328,26,57,22,35
3034,607,CAJAMARCA,HUALGAYOC,202106,133,6,36,12,24
3036,607,CAJAMARCA,HUALGAYOC,202107,60,2,21,21,0
3038,607,CAJAMARCA,HUALGAYOC,202108,31,2,18,14,4
3045,608,CAJAMARCA,JAEN,202003,0,0,23,21,2
3047,608,CAJAMARCA,JAEN,202004,39,5,21,13,8
3049,608,CAJAMARCA,JAEN,202005,175,8,24,18,6
3051,608,CAJAMARCA,JAEN,202006,701,44,75,14,61
3053,608,CAJAMARCA,JAEN,202007,2572,211,226,14,212
3055,608,CAJAMARCA,JAEN,202008,2620,108,100,11,89
3057,608,CAJAMARCA,JAEN,202009,965,27,39,14,25
3058,608,CAJAMARCA,JAEN,202010,482,21,47,16,31
3059,608,CAJAMARCA,JAEN,202011,292,12,24,15,9
3060,608,CAJAMARCA,JAEN,202012,276,19,41,15,26
3043,608,CAJAMARCA,JAEN,202101,975,42,62,13,49
3044,608,CAJAMARCA,JAEN,202102,767,66,86,12,74
3046,608,CAJAMARCA,JAEN,202103,1182,44,68,21,47
3048,608,CAJAMARCA,JAEN,202104,2255,100,114,13,101
3050,608,CAJAMARCA,JAEN,202105,1793,82,119,18,101
3052,608,CAJAMARCA,JAEN,202106,821,36,79,14,65
3054,608,CAJAMARCA,JAEN,202107,489,28,65,14,51
3056,608,CAJAMARCA,JAEN,202108,137,10,59,11,48
3063,609,CAJAMARCA,SAN IGNACIO,202003,0,0,12,19,-7
3065,609,CAJAMARCA,SAN IGNACIO,202004,0,1,19,19,0
3067,609,CAJAMARCA,SAN IGNACIO,202005,10,1,16,9,7
3069,609,CAJAMARCA,SAN IGNACIO,202006,51,6,19,15,4
3071,609,CAJAMARCA,SAN IGNACIO,202007,476,19,41,10,31
3073,609,CAJAMARCA,SAN IGNACIO,202008,877,30,44,21,23
3075,609,CAJAMARCA,SAN IGNACIO,202009,561,18,28,14,14
3076,609,CAJAMARCA,SAN IGNACIO,202010,177,4,23,21,2
3077,609,CAJAMARCA,SAN IGNACIO,202011,108,8,24,18,6
3078,609,CAJAMARCA,SAN IGNACIO,202012,83,5,18,11,7
3061,609,CAJAMARCA,SAN IGNACIO,202101,123,13,42,18,24
3062,609,CAJAMARCA,SAN IGNACIO,202102,220,19,41,15,26
3064,609,CAJAMARCA,SAN IGNACIO,202103,345,9,42,19,23
3066,609,CAJAMARCA,SAN IGNACIO,202104,754,32,55,19,36
3068,609,CAJAMARCA,SAN IGNACIO,202105,514,36,73,9,64
3070,609,CAJAMARCA,SAN IGNACIO,202106,318,16,40,15,25
3072,609,CAJAMARCA,SAN IGNACIO,202107,200,9,33,10,23
3074,609,CAJAMARCA,SAN IGNACIO,202108,72,6,43,21,22
3081,610,CAJAMARCA,SAN MARCOS,202003,0,0,10,22,-12
3083,610,CAJAMARCA,SAN MARCOS,202004,0,0,8,20,-12
3085,610,CAJAMARCA,SAN MARCOS,202005,4,1,24,15,9
3087,610,CAJAMARCA,SAN MARCOS,202006,7,1,14,18,-4
3089,610,CAJAMARCA,SAN MARCOS,202007,30,2,14,26,-12
3091,610,CAJAMARCA,SAN MARCOS,202008,107,8,29,17,12
3093,610,CAJAMARCA,SAN MARCOS,202009,22,3,21,17,4
3094,610,CAJAMARCA,SAN MARCOS,202010,25,2,18,18,0
3095,610,CAJAMARCA,SAN MARCOS,202011,24,5,21,22,-1
3096,610,CAJAMARCA,SAN MARCOS,202012,46,3,15,24,-9
3079,610,CAJAMARCA,SAN MARCOS,202101,30,4,15,14,1
3080,610,CAJAMARCA,SAN MARCOS,202102,78,5,18,13,5
3082,610,CAJAMARCA,SAN MARCOS,202103,210,19,63,22,41
3084,610,CAJAMARCA,SAN MARCOS,202104,191,29,51,20,31
3086,610,CAJAMARCA,SAN MARCOS,202105,118,21,42,15,27
3088,610,CAJAMARCA,SAN MARCOS,202106,28,7,23,18,5
3090,610,CAJAMARCA,SAN MARCOS,202107,4,2,15,26,-11
3092,610,CAJAMARCA,SAN MARCOS,202108,2,2,18,17,1
3099,611,CAJAMARCA,SAN MIGUEL,202003,0,0,17,8,9
3101,611,CAJAMARCA,SAN MIGUEL,202004,3,0,17,7,10
3103,611,CAJAMARCA,SAN MIGUEL,202005,17,1,17,6,11
3105,611,CAJAMARCA,SAN MIGUEL,202006,39,4,17,7,10
3107,611,CAJAMARCA,SAN MIGUEL,202007,50,7,30,6,24
3109,611,CAJAMARCA,SAN MIGUEL,202008,141,7,33,6,27
3111,611,CAJAMARCA,SAN MIGUEL,202009,45,2,21,9,12
3112,611,CAJAMARCA,SAN MIGUEL,202010,14,2,22,7,15
3113,611,CAJAMARCA,SAN MIGUEL,202011,17,1,11,4,7
3114,611,CAJAMARCA,SAN MIGUEL,202012,15,1,8,4,4
3097,611,CAJAMARCA,SAN MIGUEL,202101,31,6,32,10,22
3098,611,CAJAMARCA,SAN MIGUEL,202102,79,11,29,10,19
3100,611,CAJAMARCA,SAN MIGUEL,202103,149,11,32,8,24
3102,611,CAJAMARCA,SAN MIGUEL,202104,243,21,57,7,50
3104,611,CAJAMARCA,SAN MIGUEL,202105,170,19,45,6,39
3106,611,CAJAMARCA,SAN MIGUEL,202106,99,7,17,7,10
3108,611,CAJAMARCA,SAN MIGUEL,202107,37,5,17,6,11
3110,611,CAJAMARCA,SAN MIGUEL,202108,9,2,15,6,9
3117,612,CAJAMARCA,SAN PABLO,202003,0,0,3,9,-6
3119,612,CAJAMARCA,SAN PABLO,202004,3,0,4,10,-6
3121,612,CAJAMARCA,SAN PABLO,202005,5,0,7,16,-9
3123,612,CAJAMARCA,SAN PABLO,202006,5,0,4,9,-5
3125,612,CAJAMARCA,SAN PABLO,202007,33,3,9,10,-1
3127,612,CAJAMARCA,SAN PABLO,202008,49,0,8,12,-4
3129,612,CAJAMARCA,SAN PABLO,202009,23,0,8,9,-1
3130,612,CAJAMARCA,SAN PABLO,202010,12,3,17,9,8
3131,612,CAJAMARCA,SAN PABLO,202011,16,2,12,8,4
3132,612,CAJAMARCA,SAN PABLO,202012,18,1,11,7,4
3115,612,CAJAMARCA,SAN PABLO,202101,26,4,13,6,7
3116,612,CAJAMARCA,SAN PABLO,202102,48,6,13,9,4
3118,612,CAJAMARCA,SAN PABLO,202103,145,13,22,9,13
3120,612,CAJAMARCA,SAN PABLO,202104,106,8,28,10,18
3122,612,CAJAMARCA,SAN PABLO,202105,34,10,19,16,3
3124,612,CAJAMARCA,SAN PABLO,202106,8,1,13,9,4
3126,612,CAJAMARCA,SAN PABLO,202107,15,0,12,10,2
3128,612,CAJAMARCA,SAN PABLO,202108,4,0,3,12,-9
3135,613,CAJAMARCA,SANTA CRUZ,202003,0,0,11,21,-10
3137,613,CAJAMARCA,SANTA CRUZ,202004,42,2,10,13,-3
3139,613,CAJAMARCA,SANTA CRUZ,202005,49,0,15,8,7
3141,613,CAJAMARCA,SANTA CRUZ,202006,23,4,8,6,2
3143,613,CAJAMARCA,SANTA CRUZ,202007,15,1,16,13,3
3145,613,CAJAMARCA,SANTA CRUZ,202008,97,4,16,12,4
3147,613,CAJAMARCA,SANTA CRUZ,202009,31,7,16,5,11
3148,613,CAJAMARCA,SANTA CRUZ,202010,43,2,8,7,1
3149,613,CAJAMARCA,SANTA CRUZ,202011,17,2,5,3,2
3150,613,CAJAMARCA,SANTA CRUZ,202012,27,6,7,3,4
3133,613,CAJAMARCA,SANTA CRUZ,202101,21,3,10,10,0
3134,613,CAJAMARCA,SANTA CRUZ,202102,35,4,15,13,2
3136,613,CAJAMARCA,SANTA CRUZ,202103,48,6,10,21,-11
3138,613,CAJAMARCA,SANTA CRUZ,202104,137,15,18,13,5
3140,613,CAJAMARCA,SANTA CRUZ,202105,132,14,23,8,15
3142,613,CAJAMARCA,SANTA CRUZ,202106,71,3,13,6,7
3144,613,CAJAMARCA,SANTA CRUZ,202107,38,2,6,13,-7
3146,613,CAJAMARCA,SANTA CRUZ,202108,21,3,9,12,-3
3153,701,CALLAO,PROV. CONST. DEL CALLAO,202003,39,5,422,364,58
3155,701,CALLAO,PROV. CONST. DEL CALLAO,202004,4070,375,663,332,331
3157,701,CALLAO,PROV. CONST. DEL CALLAO,202005,8145,1285,1721,358,1363
3159,701,CALLAO,PROV. CONST. DEL CALLAO,202006,5382,1134,1582,370,1212
3161,701,CALLAO,PROV. CONST. DEL CALLAO,202007,3628,828,1213,381,832
3163,701,CALLAO,PROV. CONST. DEL CALLAO,202008,6119,715,1068,389,679
3165,701,CALLAO,PROV. CONST. DEL CALLAO,202009,5776,385,749,424,325
3166,701,CALLAO,PROV. CONST. DEL CALLAO,202010,3674,211,553,385,168
3167,701,CALLAO,PROV. CONST. DEL CALLAO,202011,2493,125,449,331,118
3168,701,CALLAO,PROV. CONST. DEL CALLAO,202012,2119,155,510,352,158
3151,701,CALLAO,PROV. CONST. DEL CALLAO,202101,5421,535,923,362,561
3152,701,CALLAO,PROV. CONST. DEL CALLAO,202102,8849,1068,1439,386,1053
3154,701,CALLAO,PROV. CONST. DEL CALLAO,202103,15446,1130,1508,364,1144
3156,701,CALLAO,PROV. CONST. DEL CALLAO,202104,16820,1016,1423,332,1091
3158,701,CALLAO,PROV. CONST. DEL CALLAO,202105,3079,571,952,358,594
3160,701,CALLAO,PROV. CONST. DEL CALLAO,202106,1732,217,601,370,231
3162,701,CALLAO,PROV. CONST. DEL CALLAO,202107,1113,97,490,381,109
3164,701,CALLAO,PROV. CONST. DEL CALLAO,202108,948,55,475,389,86
3171,801,CUSCO,CUSCO,202003,33,5,168,145,23
3173,801,CUSCO,CUSCO,202004,224,2,138,142,-4
3175,801,CUSCO,CUSCO,202005,579,9,154,152,2
3177,801,CUSCO,CUSCO,202006,361,16,155,183,-28
3179,801,CUSCO,CUSCO,202007,2099,191,384,177,207
3181,801,CUSCO,CUSCO,202008,8047,543,773,180,593
3183,801,CUSCO,CUSCO,202009,3177,115,237,161,76
3184,801,CUSCO,CUSCO,202010,795,52,160,161,-1
3185,801,CUSCO,CUSCO,202011,715,28,139,170,-31
3186,801,CUSCO,CUSCO,202012,756,34,168,174,-6
3169,801,CUSCO,CUSCO,202101,1906,85,222,138,84
3170,801,CUSCO,CUSCO,202102,3486,193,304,149,155
3172,801,CUSCO,CUSCO,202103,5111,273,408,145,263
3174,801,CUSCO,CUSCO,202104,5939,359,491,142,349
3176,801,CUSCO,CUSCO,202105,4071,303,461,152,309
3178,801,CUSCO,CUSCO,202106,2335,114,254,183,71
3180,801,CUSCO,CUSCO,202107,1311,57,199,177,22
3182,801,CUSCO,CUSCO,202108,686,37,192,180,12
3189,802,CUSCO,ACOMAYO,202003,0,0,11,16,-5
3191,802,CUSCO,ACOMAYO,202004,0,0,11,16,-5
3193,802,CUSCO,ACOMAYO,202005,14,1,15,15,0
3195,802,CUSCO,ACOMAYO,202006,10,1,6,15,-9
3197,802,CUSCO,ACOMAYO,202007,3,1,11,19,-8
3199,802,CUSCO,ACOMAYO,202008,44,4,19,18,1
3201,802,CUSCO,ACOMAYO,202009,52,9,19,11,8
3202,802,CUSCO,ACOMAYO,202010,8,1,22,16,6
3203,802,CUSCO,ACOMAYO,202011,6,4,19,12,7
3204,802,CUSCO,ACOMAYO,202012,4,1,19,20,-1
3187,802,CUSCO,ACOMAYO,202101,14,2,18,19,-1
3188,802,CUSCO,ACOMAYO,202102,42,5,26,10,16
3190,802,CUSCO,ACOMAYO,202103,43,5,16,16,0
3192,802,CUSCO,ACOMAYO,202104,126,2,25,16,9
3194,802,CUSCO,ACOMAYO,202105,101,4,28,15,13
3196,802,CUSCO,ACOMAYO,202106,91,8,29,15,14
3198,802,CUSCO,ACOMAYO,202107,30,4,13,19,-6
3200,802,CUSCO,ACOMAYO,202108,20,0,9,18,-9
3207,803,CUSCO,ANTA,202003,0,0,19,24,-5
3209,803,CUSCO,ANTA,202004,4,1,20,24,-4
3211,803,CUSCO,ANTA,202005,39,1,20,28,-8
3213,803,CUSCO,ANTA,202006,26,0,26,27,-1
3215,803,CUSCO,ANTA,202007,33,3,29,32,-3
3217,803,CUSCO,ANTA,202008,244,27,64,35,29
3219,803,CUSCO,ANTA,202009,167,13,33,16,17
3220,803,CUSCO,ANTA,202010,27,10,34,24,10
3221,803,CUSCO,ANTA,202011,18,2,28,20,8
3222,803,CUSCO,ANTA,202012,23,5,33,28,5
3205,803,CUSCO,ANTA,202101,36,4,40,37,3
3206,803,CUSCO,ANTA,202102,196,24,47,31,16
3208,803,CUSCO,ANTA,202103,437,37,76,24,52
3210,803,CUSCO,ANTA,202104,471,45,80,24,56
3212,803,CUSCO,ANTA,202105,186,30,66,28,38
3214,803,CUSCO,ANTA,202106,89,12,51,27,24
3216,803,CUSCO,ANTA,202107,46,8,38,32,6
3218,803,CUSCO,ANTA,202108,14,1,24,35,-11
3225,804,CUSCO,CALCA,202003,0,0,27,20,7
3227,804,CUSCO,CALCA,202004,3,0,23,17,6
3229,804,CUSCO,CALCA,202005,21,0,24,26,-2
3231,804,CUSCO,CALCA,202006,13,1,46,22,24
3233,804,CUSCO,CALCA,202007,25,3,31,28,3
3235,804,CUSCO,CALCA,202008,131,11,48,30,18
3237,804,CUSCO,CALCA,202009,71,9,32,32,0
3238,804,CUSCO,CALCA,202010,30,3,40,40,0
3239,804,CUSCO,CALCA,202011,20,1,26,26,0
3240,804,CUSCO,CALCA,202012,14,3,42,28,14
3223,804,CUSCO,CALCA,202101,42,9,40,23,17
3224,804,CUSCO,CALCA,202102,105,8,38,26,12
3226,804,CUSCO,CALCA,202103,270,12,57,20,37
3228,804,CUSCO,CALCA,202104,345,25,57,17,40
3230,804,CUSCO,CALCA,202105,208,20,45,26,19
3232,804,CUSCO,CALCA,202106,86,5,36,22,14
3234,804,CUSCO,CALCA,202107,45,2,37,28,9
3236,804,CUSCO,CALCA,202108,19,2,37,30,7
3243,805,CUSCO,CANAS,202003,0,0,23,16,7
3245,805,CUSCO,CANAS,202004,3,0,19,18,1
3247,805,CUSCO,CANAS,202005,11,0,15,21,-6
3249,805,CUSCO,CANAS,202006,4,0,14,24,-10
3251,805,CUSCO,CANAS,202007,9,3,20,20,0
3253,805,CUSCO,CANAS,202008,42,6,29,7,22
3255,805,CUSCO,CANAS,202009,46,1,22,14,8
3256,805,CUSCO,CANAS,202010,9,0,21,19,2
3257,805,CUSCO,CANAS,202011,9,1,16,23,-7
3258,805,CUSCO,CANAS,202012,3,0,22,15,7
3241,805,CUSCO,CANAS,202101,18,7,32,29,3
3242,805,CUSCO,CANAS,202102,60,10,33,19,14
3244,805,CUSCO,CANAS,202103,120,9,34,16,18
3246,805,CUSCO,CANAS,202104,119,9,25,18,7
3248,805,CUSCO,CANAS,202105,127,15,43,21,22
3250,805,CUSCO,CANAS,202106,132,11,31,24,7
3252,805,CUSCO,CANAS,202107,57,4,25,20,5
3254,805,CUSCO,CANAS,202108,15,4,22,7,15
3261,806,CUSCO,CANCHIS,202003,0,0,49,47,2
3263,806,CUSCO,CANCHIS,202004,15,0,42,35,7
3265,806,CUSCO,CANCHIS,202005,14,2,41,46,-5
3267,806,CUSCO,CANCHIS,202006,22,1,43,49,-6
3269,806,CUSCO,CANCHIS,202007,72,9,65,50,15
3271,806,CUSCO,CANCHIS,202008,486,49,116,55,61
3273,806,CUSCO,CANCHIS,202009,363,29,77,45,32
3274,806,CUSCO,CANCHIS,202010,188,10,64,49,15
3275,806,CUSCO,CANCHIS,202011,86,6,52,54,-2
3276,806,CUSCO,CANCHIS,202012,57,6,56,67,-11
3259,806,CUSCO,CANCHIS,202101,188,21,75,57,18
3260,806,CUSCO,CANCHIS,202102,474,62,124,48,76
3262,806,CUSCO,CANCHIS,202103,493,60,126,47,79
3264,806,CUSCO,CANCHIS,202104,499,45,95,35,60
3266,806,CUSCO,CANCHIS,202105,717,64,125,46,79
3268,806,CUSCO,CANCHIS,202106,523,51,105,49,56
3270,806,CUSCO,CANCHIS,202107,245,23,80,50,30
3272,806,CUSCO,CANCHIS,202108,84,2,30,55,-25
3279,807,CUSCO,CHUMBIVILCAS,202003,0,0,30,46,-16
3281,807,CUSCO,CHUMBIVILCAS,202004,3,0,29,17,12
3283,807,CUSCO,CHUMBIVILCAS,202005,17,0,30,26,4
3285,807,CUSCO,CHUMBIVILCAS,202006,2,1,30,29,1
3287,807,CUSCO,CHUMBIVILCAS,202007,9,2,31,25,6
3289,807,CUSCO,CHUMBIVILCAS,202008,110,3,37,36,1
3291,807,CUSCO,CHUMBIVILCAS,202009,60,2,41,36,5
3292,807,CUSCO,CHUMBIVILCAS,202010,35,2,31,20,11
3293,807,CUSCO,CHUMBIVILCAS,202011,16,1,27,32,-5
3294,807,CUSCO,CHUMBIVILCAS,202012,63,1,39,32,7
3277,807,CUSCO,CHUMBIVILCAS,202101,322,27,80,39,41
3278,807,CUSCO,CHUMBIVILCAS,202102,290,28,77,37,40
3280,807,CUSCO,CHUMBIVILCAS,202103,110,7,52,46,6
3282,807,CUSCO,CHUMBIVILCAS,202104,165,15,48,17,31
3284,807,CUSCO,CHUMBIVILCAS,202105,300,14,47,26,21
3286,807,CUSCO,CHUMBIVILCAS,202106,180,21,52,29,23
3288,807,CUSCO,CHUMBIVILCAS,202107,80,6,42,25,17
3290,807,CUSCO,CHUMBIVILCAS,202108,49,4,27,36,-9
3297,808,CUSCO,ESPINAR,202003,0,0,24,23,1
3299,808,CUSCO,ESPINAR,202004,7,0,28,26,2
3301,808,CUSCO,ESPINAR,202005,29,1,19,26,-7
3303,808,CUSCO,ESPINAR,202006,20,2,25,29,-4
3305,808,CUSCO,ESPINAR,202007,11,7,34,33,1
3307,808,CUSCO,ESPINAR,202008,96,21,57,32,25
3309,808,CUSCO,ESPINAR,202009,177,4,28,26,2
3310,808,CUSCO,ESPINAR,202010,359,1,34,30,4
3311,808,CUSCO,ESPINAR,202011,75,2,26,25,1
3312,808,CUSCO,ESPINAR,202012,91,3,30,25,5
3295,808,CUSCO,ESPINAR,202101,120,7,52,30,22
3296,808,CUSCO,ESPINAR,202102,107,12,42,20,22
3298,808,CUSCO,ESPINAR,202103,120,8,26,23,3
3300,808,CUSCO,ESPINAR,202104,226,12,45,26,19
3302,808,CUSCO,ESPINAR,202105,242,15,51,26,25
3304,808,CUSCO,ESPINAR,202106,156,15,57,29,28
3306,808,CUSCO,ESPINAR,202107,105,8,40,33,7
3308,808,CUSCO,ESPINAR,202108,37,2,24,32,-8
3315,809,CUSCO,LA CONVENCION,202003,1,0,51,66,-15
3317,809,CUSCO,LA CONVENCION,202004,7,1,59,74,-15
3319,809,CUSCO,LA CONVENCION,202005,65,1,59,67,-8
3321,809,CUSCO,LA CONVENCION,202006,271,7,78,57,21
3323,809,CUSCO,LA CONVENCION,202007,682,26,88,53,35
3325,809,CUSCO,LA CONVENCION,202008,978,42,104,66,38
3327,809,CUSCO,LA CONVENCION,202009,501,29,87,69,18
3328,809,CUSCO,LA CONVENCION,202010,368,12,79,79,0
3329,809,CUSCO,LA CONVENCION,202011,249,14,86,67,19
3330,809,CUSCO,LA CONVENCION,202012,257,9,82,78,4
3313,809,CUSCO,LA CONVENCION,202101,730,34,124,81,43
3314,809,CUSCO,LA CONVENCION,202102,1060,60,138,52,86
3316,809,CUSCO,LA CONVENCION,202103,1131,62,140,66,74
3318,809,CUSCO,LA CONVENCION,202104,1728,77,155,74,81
3320,809,CUSCO,LA CONVENCION,202105,1390,65,138,67,71
3322,809,CUSCO,LA CONVENCION,202106,687,23,96,57,39
3324,809,CUSCO,LA CONVENCION,202107,384,6,80,53,27
3326,809,CUSCO,LA CONVENCION,202108,306,11,76,66,10
3333,810,CUSCO,PARURO,202003,0,1,15,19,-4
3335,810,CUSCO,PARURO,202004,0,0,13,9,4
3337,810,CUSCO,PARURO,202005,16,0,12,13,-1
3339,810,CUSCO,PARURO,202006,6,0,10,20,-10
3341,810,CUSCO,PARURO,202007,5,0,12,29,-17
3343,810,CUSCO,PARURO,202008,27,6,21,18,3
3345,810,CUSCO,PARURO,202009,18,5,20,24,-4
3346,810,CUSCO,PARURO,202010,29,2,10,17,-7
3347,810,CUSCO,PARURO,202011,3,1,16,7,9
3348,810,CUSCO,PARURO,202012,4,2,15,29,-14
3331,810,CUSCO,PARURO,202101,12,2,26,16,10
3332,810,CUSCO,PARURO,202102,31,3,14,17,-3
3334,810,CUSCO,PARURO,202103,86,5,19,19,0
3336,810,CUSCO,PARURO,202104,114,11,29,9,20
3338,810,CUSCO,PARURO,202105,64,10,23,13,10
3340,810,CUSCO,PARURO,202106,42,4,20,20,0
3342,810,CUSCO,PARURO,202107,32,4,14,29,-15
3344,810,CUSCO,PARURO,202108,3,0,10,18,-8
3351,811,CUSCO,PAUCARTAMBO,202003,0,0,12,22,-10
3353,811,CUSCO,PAUCARTAMBO,202004,1,0,21,21,0
3355,811,CUSCO,PAUCARTAMBO,202005,6,0,12,18,-6
3357,811,CUSCO,PAUCARTAMBO,202006,4,0,9,25,-16
3359,811,CUSCO,PAUCARTAMBO,202007,10,1,22,22,0
3361,811,CUSCO,PAUCARTAMBO,202008,78,2,27,17,10
3363,811,CUSCO,PAUCARTAMBO,202009,38,1,21,19,2
3364,811,CUSCO,PAUCARTAMBO,202010,19,4,20,13,7
3365,811,CUSCO,PAUCARTAMBO,202011,15,0,17,13,4
3366,811,CUSCO,PAUCARTAMBO,202012,4,0,16,22,-6
3349,811,CUSCO,PAUCARTAMBO,202101,10,1,21,27,-6
3350,811,CUSCO,PAUCARTAMBO,202102,47,4,23,19,4
3352,811,CUSCO,PAUCARTAMBO,202103,135,16,41,22,19
3354,811,CUSCO,PAUCARTAMBO,202104,241,34,60,21,39
3356,811,CUSCO,PAUCARTAMBO,202105,73,9,36,18,18
3358,811,CUSCO,PAUCARTAMBO,202106,34,2,22,25,-3
3360,811,CUSCO,PAUCARTAMBO,202107,22,2,23,22,1
3362,811,CUSCO,PAUCARTAMBO,202108,10,1,24,17,7
3369,812,CUSCO,QUISPICANCHI,202003,0,0,26,45,-19
3371,812,CUSCO,QUISPICANCHI,202004,4,0,26,40,-14
3373,812,CUSCO,QUISPICANCHI,202005,15,0,36,43,-7
3375,812,CUSCO,QUISPICANCHI,202006,16,3,40,39,1
3377,812,CUSCO,QUISPICANCHI,202007,58,9,42,45,-3
3379,812,CUSCO,QUISPICANCHI,202008,339,34,90,33,57
3381,812,CUSCO,QUISPICANCHI,202009,144,19,46,36,10
3382,812,CUSCO,QUISPICANCHI,202010,42,5,34,46,-12
3383,812,CUSCO,QUISPICANCHI,202011,50,9,37,49,-12
3384,812,CUSCO,QUISPICANCHI,202012,22,9,54,42,12
3367,812,CUSCO,QUISPICANCHI,202101,84,16,56,44,12
3368,812,CUSCO,QUISPICANCHI,202102,254,29,65,42,23
3370,812,CUSCO,QUISPICANCHI,202103,396,41,83,45,38
3372,812,CUSCO,QUISPICANCHI,202104,505,39,85,40,45
3374,812,CUSCO,QUISPICANCHI,202105,373,58,106,43,63
3376,812,CUSCO,QUISPICANCHI,202106,225,23,61,39,22
3378,812,CUSCO,QUISPICANCHI,202107,150,13,46,45,1
3380,812,CUSCO,QUISPICANCHI,202108,39,7,38,33,5
3387,813,CUSCO,URUBAMBA,202003,0,0,26,25,1
3389,813,CUSCO,URUBAMBA,202004,12,0,21,19,2
3391,813,CUSCO,URUBAMBA,202005,5,0,18,20,-2
3393,813,CUSCO,URUBAMBA,202006,20,0,35,33,2
3395,813,CUSCO,URUBAMBA,202007,36,6,37,27,10
3397,813,CUSCO,URUBAMBA,202008,213,20,54,34,20
3399,813,CUSCO,URUBAMBA,202009,129,19,58,39,19
3400,813,CUSCO,URUBAMBA,202010,49,7,42,25,17
3401,813,CUSCO,URUBAMBA,202011,72,3,28,25,3
3402,813,CUSCO,URUBAMBA,202012,17,1,35,23,12
3385,813,CUSCO,URUBAMBA,202101,78,5,42,31,11
3386,813,CUSCO,URUBAMBA,202102,297,31,76,33,43
3388,813,CUSCO,URUBAMBA,202103,424,34,73,25,48
3390,813,CUSCO,URUBAMBA,202104,290,29,60,19,41
3392,813,CUSCO,URUBAMBA,202105,226,22,59,20,39
3394,813,CUSCO,URUBAMBA,202106,124,9,41,33,8
3396,813,CUSCO,URUBAMBA,202107,85,5,43,27,16
3398,813,CUSCO,URUBAMBA,202108,32,4,34,34,0
3405,901,HUANCAVELICA,HUANCAVELICA,202003,1,0,47,44,3
3407,901,HUANCAVELICA,HUANCAVELICA,202004,67,0,61,57,4
3409,901,HUANCAVELICA,HUANCAVELICA,202005,176,4,68,56,12
3411,901,HUANCAVELICA,HUANCAVELICA,202006,138,4,64,51,13
3413,901,HUANCAVELICA,HUANCAVELICA,202007,557,36,107,48,59
3415,901,HUANCAVELICA,HUANCAVELICA,202008,1917,100,151,52,99
3417,901,HUANCAVELICA,HUANCAVELICA,202009,1045,23,64,47,17
3418,901,HUANCAVELICA,HUANCAVELICA,202010,153,11,53,50,3
3419,901,HUANCAVELICA,HUANCAVELICA,202011,145,7,55,48,7
3420,901,HUANCAVELICA,HUANCAVELICA,202012,121,2,45,51,-6
3403,901,HUANCAVELICA,HUANCAVELICA,202101,401,32,101,36,65
3404,901,HUANCAVELICA,HUANCAVELICA,202102,507,66,127,56,71
3406,901,HUANCAVELICA,HUANCAVELICA,202103,518,58,139,44,95
3408,901,HUANCAVELICA,HUANCAVELICA,202104,1065,90,150,57,93
3410,901,HUANCAVELICA,HUANCAVELICA,202105,552,47,127,56,71
3412,901,HUANCAVELICA,HUANCAVELICA,202106,201,22,81,51,30
3414,901,HUANCAVELICA,HUANCAVELICA,202107,154,6,79,48,31
3416,901,HUANCAVELICA,HUANCAVELICA,202108,128,9,55,52,3
3423,902,HUANCAVELICA,ACOBAMBA,202003,0,0,15,17,-2
3425,902,HUANCAVELICA,ACOBAMBA,202004,42,2,14,13,1
3427,902,HUANCAVELICA,ACOBAMBA,202005,86,2,18,23,-5
3429,902,HUANCAVELICA,ACOBAMBA,202006,77,1,13,23,-10
3431,902,HUANCAVELICA,ACOBAMBA,202007,68,11,30,19,11
3433,902,HUANCAVELICA,ACOBAMBA,202008,179,13,38,22,16
3435,902,HUANCAVELICA,ACOBAMBA,202009,118,8,29,23,6
3436,902,HUANCAVELICA,ACOBAMBA,202010,60,3,14,23,-9
3437,902,HUANCAVELICA,ACOBAMBA,202011,21,1,22,9,13
3438,902,HUANCAVELICA,ACOBAMBA,202012,9,0,23,20,3
3421,902,HUANCAVELICA,ACOBAMBA,202101,22,4,18,17,1
3422,902,HUANCAVELICA,ACOBAMBA,202102,48,7,29,18,11
3424,902,HUANCAVELICA,ACOBAMBA,202103,162,19,47,17,30
3426,902,HUANCAVELICA,ACOBAMBA,202104,206,24,46,13,33
3428,902,HUANCAVELICA,ACOBAMBA,202105,96,17,53,23,30
3430,902,HUANCAVELICA,ACOBAMBA,202106,27,4,25,23,2
3432,902,HUANCAVELICA,ACOBAMBA,202107,18,5,21,19,2
3434,902,HUANCAVELICA,ACOBAMBA,202108,15,1,15,22,-7
3441,903,HUANCAVELICA,ANGARAES,202003,0,0,37,21,16
3443,903,HUANCAVELICA,ANGARAES,202004,9,0,38,15,23
3445,903,HUANCAVELICA,ANGARAES,202005,68,1,21,15,6
3447,903,HUANCAVELICA,ANGARAES,202006,38,0,24,11,13
3449,903,HUANCAVELICA,ANGARAES,202007,62,16,45,21,24
3451,903,HUANCAVELICA,ANGARAES,202008,381,23,46,20,26
3453,903,HUANCAVELICA,ANGARAES,202009,189,8,22,18,4
3454,903,HUANCAVELICA,ANGARAES,202010,45,8,32,29,3
3455,903,HUANCAVELICA,ANGARAES,202011,47,4,27,17,10
3456,903,HUANCAVELICA,ANGARAES,202012,27,4,28,24,4
3439,903,HUANCAVELICA,ANGARAES,202101,76,10,30,22,8
3440,903,HUANCAVELICA,ANGARAES,202102,73,7,26,20,6
3442,903,HUANCAVELICA,ANGARAES,202103,112,15,37,21,16
3444,903,HUANCAVELICA,ANGARAES,202104,184,23,51,15,36
3446,903,HUANCAVELICA,ANGARAES,202105,198,16,34,15,19
3448,903,HUANCAVELICA,ANGARAES,202106,74,5,29,11,18
3450,903,HUANCAVELICA,ANGARAES,202107,20,3,33,21,12
3452,903,HUANCAVELICA,ANGARAES,202108,23,1,17,20,-3
3459,904,HUANCAVELICA,CASTROVIRREYNA,202003,0,0,3,9,-6
3461,904,HUANCAVELICA,CASTROVIRREYNA,202004,1,1,6,4,2
3463,904,HUANCAVELICA,CASTROVIRREYNA,202005,23,1,10,7,3
3465,904,HUANCAVELICA,CASTROVIRREYNA,202006,22,0,13,8,5
3467,904,HUANCAVELICA,CASTROVIRREYNA,202007,32,0,9,7,2
3469,904,HUANCAVELICA,CASTROVIRREYNA,202008,65,1,13,17,-4
3471,904,HUANCAVELICA,CASTROVIRREYNA,202009,28,0,13,8,5
3472,904,HUANCAVELICA,CASTROVIRREYNA,202010,11,2,9,7,2
3473,904,HUANCAVELICA,CASTROVIRREYNA,202011,10,1,6,8,-2
3474,904,HUANCAVELICA,CASTROVIRREYNA,202012,4,0,9,10,-1
3457,904,HUANCAVELICA,CASTROVIRREYNA,202101,12,1,12,8,4
3458,904,HUANCAVELICA,CASTROVIRREYNA,202102,48,7,23,6,17
3460,904,HUANCAVELICA,CASTROVIRREYNA,202103,31,4,14,9,5
3462,904,HUANCAVELICA,CASTROVIRREYNA,202104,114,5,29,4,25
3464,904,HUANCAVELICA,CASTROVIRREYNA,202105,47,9,24,7,17
3466,904,HUANCAVELICA,CASTROVIRREYNA,202106,5,2,11,8,3
3468,904,HUANCAVELICA,CASTROVIRREYNA,202107,5,0,15,7,8
3470,904,HUANCAVELICA,CASTROVIRREYNA,202108,19,0,10,17,-7
3477,905,HUANCAVELICA,CHURCAMPA,202003,0,0,8,14,-6
3479,905,HUANCAVELICA,CHURCAMPA,202004,7,1,17,15,2
3481,905,HUANCAVELICA,CHURCAMPA,202005,13,1,18,17,1
3483,905,HUANCAVELICA,CHURCAMPA,202006,22,1,17,17,0
3485,905,HUANCAVELICA,CHURCAMPA,202007,35,6,16,12,4
3487,905,HUANCAVELICA,CHURCAMPA,202008,97,3,26,20,6
3489,905,HUANCAVELICA,CHURCAMPA,202009,103,3,28,25,3
3490,905,HUANCAVELICA,CHURCAMPA,202010,33,5,20,11,9
3491,905,HUANCAVELICA,CHURCAMPA,202011,35,1,15,17,-2
3492,905,HUANCAVELICA,CHURCAMPA,202012,12,3,17,11,6
3475,905,HUANCAVELICA,CHURCAMPA,202101,27,1,20,16,4
3476,905,HUANCAVELICA,CHURCAMPA,202102,65,6,22,13,9
3478,905,HUANCAVELICA,CHURCAMPA,202103,109,5,30,14,16
3480,905,HUANCAVELICA,CHURCAMPA,202104,257,12,34,15,19
3482,905,HUANCAVELICA,CHURCAMPA,202105,154,9,28,17,11
3484,905,HUANCAVELICA,CHURCAMPA,202106,47,2,18,17,1
3486,905,HUANCAVELICA,CHURCAMPA,202107,33,3,18,12,6
3488,905,HUANCAVELICA,CHURCAMPA,202108,23,1,16,20,-4
3495,906,HUANCAVELICA,HUAYTARA,202003,0,0,8,9,-1
3497,906,HUANCAVELICA,HUAYTARA,202004,1,1,10,11,-1
3499,906,HUANCAVELICA,HUAYTARA,202005,30,2,8,9,-1
3501,906,HUANCAVELICA,HUAYTARA,202006,16,2,14,9,5
3503,906,HUANCAVELICA,HUAYTARA,202007,31,0,8,11,-3
3505,906,HUANCAVELICA,HUAYTARA,202008,73,7,18,13,5
3507,906,HUANCAVELICA,HUAYTARA,202009,49,2,11,9,2
3508,906,HUANCAVELICA,HUAYTARA,202010,15,0,8,12,-4
3509,906,HUANCAVELICA,HUAYTARA,202011,21,1,10,10,0
3510,906,HUANCAVELICA,HUAYTARA,202012,24,2,17,8,9
3493,906,HUANCAVELICA,HUAYTARA,202101,58,2,19,11,8
3494,906,HUANCAVELICA,HUAYTARA,202102,53,9,35,12,23
3496,906,HUANCAVELICA,HUAYTARA,202103,37,4,24,9,15
3498,906,HUANCAVELICA,HUAYTARA,202104,71,5,20,11,9
3500,906,HUANCAVELICA,HUAYTARA,202105,48,11,28,9,19
3502,906,HUANCAVELICA,HUAYTARA,202106,36,6,15,9,6
3504,906,HUANCAVELICA,HUAYTARA,202107,31,0,13,11,2
3506,906,HUANCAVELICA,HUAYTARA,202108,9,1,14,13,1
3513,907,HUANCAVELICA,TAYACAJA,202003,0,0,41,33,8
3515,907,HUANCAVELICA,TAYACAJA,202004,8,0,48,40,8
3517,907,HUANCAVELICA,TAYACAJA,202005,26,1,49,31,18
3519,907,HUANCAVELICA,TAYACAJA,202006,37,3,49,42,7
3521,907,HUANCAVELICA,TAYACAJA,202007,144,12,55,45,10
3523,907,HUANCAVELICA,TAYACAJA,202008,362,19,64,51,13
3525,907,HUANCAVELICA,TAYACAJA,202009,328,10,48,40,8
3526,907,HUANCAVELICA,TAYACAJA,202010,225,3,31,49,-18
3527,907,HUANCAVELICA,TAYACAJA,202011,27,3,40,36,4
3528,907,HUANCAVELICA,TAYACAJA,202012,24,1,46,35,11
3511,907,HUANCAVELICA,TAYACAJA,202101,69,13,63,42,21
3512,907,HUANCAVELICA,TAYACAJA,202102,326,44,104,45,59
3514,907,HUANCAVELICA,TAYACAJA,202103,325,30,87,33,54
3516,907,HUANCAVELICA,TAYACAJA,202104,377,26,80,40,40
3518,907,HUANCAVELICA,TAYACAJA,202105,336,23,69,31,38
3520,907,HUANCAVELICA,TAYACAJA,202106,165,5,42,42,0
3522,907,HUANCAVELICA,TAYACAJA,202107,96,6,52,45,7
3524,907,HUANCAVELICA,TAYACAJA,202108,58,8,45,51,-6
3,1001,HUANUCO,HUANUCO,202003,5,0,128,117,11
5,1001,HUANUCO,HUANUCO,202004,157,2,121,116,5
7,1001,HUANUCO,HUANUCO,202005,314,32,148,108,40
9,1001,HUANUCO,HUANUCO,202006,883,72,178,115,63
11,1001,HUANUCO,HUANUCO,202007,2869,149,249,94,155
13,1001,HUANUCO,HUANUCO,202008,3339,173,298,103,195
15,1001,HUANUCO,HUANUCO,202009,1931,63,164,89,75
16,1001,HUANUCO,HUANUCO,202010,576,39,138,106,32
17,1001,HUANUCO,HUANUCO,202011,595,23,120,106,14
18,1001,HUANUCO,HUANUCO,202012,845,62,159,119,40
1,1001,HUANUCO,HUANUCO,202101,1945,297,451,103,348
2,1001,HUANUCO,HUANUCO,202102,907,204,346,78,268
4,1001,HUANUCO,HUANUCO,202103,492,86,206,117,89
6,1001,HUANUCO,HUANUCO,202104,1106,79,202,116,86
8,1001,HUANUCO,HUANUCO,202105,1047,132,252,108,144
10,1001,HUANUCO,HUANUCO,202106,697,73,214,115,99
12,1001,HUANUCO,HUANUCO,202107,608,29,164,94,70
14,1001,HUANUCO,HUANUCO,202108,256,9,124,103,21
21,1002,HUANUCO,AMBO,202003,0,0,19,14,5
23,1002,HUANUCO,AMBO,202004,5,1,21,18,3
25,1002,HUANUCO,AMBO,202005,24,3,14,14,0
27,1002,HUANUCO,AMBO,202006,21,1,17,22,-5
29,1002,HUANUCO,AMBO,202007,114,12,41,18,23
31,1002,HUANUCO,AMBO,202008,208,6,24,15,9
33,1002,HUANUCO,AMBO,202009,48,7,23,22,1
34,1002,HUANUCO,AMBO,202010,14,1,18,19,-1
35,1002,HUANUCO,AMBO,202011,48,5,21,16,5
36,1002,HUANUCO,AMBO,202012,145,10,36,15,21
19,1002,HUANUCO,AMBO,202101,143,40,58,19,39
20,1002,HUANUCO,AMBO,202102,79,16,43,11,32
22,1002,HUANUCO,AMBO,202103,65,7,24,14,10
24,1002,HUANUCO,AMBO,202104,177,14,34,18,16
26,1002,HUANUCO,AMBO,202105,199,22,43,14,29
28,1002,HUANUCO,AMBO,202106,120,9,34,22,12
30,1002,HUANUCO,AMBO,202107,61,2,21,18,3
32,1002,HUANUCO,AMBO,202108,25,2,23,15,8
39,1003,HUANUCO,DOS DE MAYO,202003,0,0,8,21,-13
41,1003,HUANUCO,DOS DE MAYO,202004,4,0,12,16,-4
43,1003,HUANUCO,DOS DE MAYO,202005,6,3,10,15,-5
45,1003,HUANUCO,DOS DE MAYO,202006,15,1,16,11,5
47,1003,HUANUCO,DOS DE MAYO,202007,123,3,19,9,10
49,1003,HUANUCO,DOS DE MAYO,202008,92,6,19,7,12
51,1003,HUANUCO,DOS DE MAYO,202009,52,0,15,14,1
52,1003,HUANUCO,DOS DE MAYO,202010,24,3,14,14,0
53,1003,HUANUCO,DOS DE MAYO,202011,10,3,8,10,-2
54,1003,HUANUCO,DOS DE MAYO,202012,40,2,11,12,-1
37,1003,HUANUCO,DOS DE MAYO,202101,29,5,11,12,-1
38,1003,HUANUCO,DOS DE MAYO,202102,33,12,26,14,12
40,1003,HUANUCO,DOS DE MAYO,202103,57,4,16,21,-5
42,1003,HUANUCO,DOS DE MAYO,202104,164,22,38,16,22
44,1003,HUANUCO,DOS DE MAYO,202105,130,17,31,15,16
46,1003,HUANUCO,DOS DE MAYO,202106,33,10,19,11,8
48,1003,HUANUCO,DOS DE MAYO,202107,24,3,16,9,7
50,1003,HUANUCO,DOS DE MAYO,202108,21,2,14,7,7
57,1004,HUANUCO,HUACAYBAMBA,202003,0,0,6,6,0
59,1004,HUANUCO,HUACAYBAMBA,202004,0,0,2,3,-1
61,1004,HUANUCO,HUACAYBAMBA,202005,3,1,5,5,0
63,1004,HUANUCO,HUACAYBAMBA,202006,2,0,9,4,5
65,1004,HUANUCO,HUACAYBAMBA,202007,2,0,3,4,-1
67,1004,HUANUCO,HUACAYBAMBA,202008,26,1,2,4,-2
69,1004,HUANUCO,HUACAYBAMBA,202009,45,2,5,9,-4
70,1004,HUANUCO,HUACAYBAMBA,202010,37,1,9,5,4
71,1004,HUANUCO,HUACAYBAMBA,202011,22,1,5,5,0
72,1004,HUANUCO,HUACAYBAMBA,202012,23,0,7,2,5
55,1004,HUANUCO,HUACAYBAMBA,202101,14,0,9,6,3
56,1004,HUANUCO,HUACAYBAMBA,202102,15,0,5,5,0
58,1004,HUANUCO,HUACAYBAMBA,202103,78,6,13,6,7
60,1004,HUANUCO,HUACAYBAMBA,202104,106,6,18,3,15
62,1004,HUANUCO,HUACAYBAMBA,202105,90,7,12,5,7
64,1004,HUANUCO,HUACAYBAMBA,202106,13,2,9,4,5
66,1004,HUANUCO,HUACAYBAMBA,202107,4,0,11,4,7
68,1004,HUANUCO,HUACAYBAMBA,202108,4,0,14,4,10
75,1005,HUANUCO,HUAMALIES,202003,0,0,20,19,1
77,1005,HUANUCO,HUAMALIES,202004,64,0,26,19,7
79,1005,HUANUCO,HUAMALIES,202005,50,3,18,18,0
81,1005,HUANUCO,HUAMALIES,202006,29,2,15,22,-7
83,1005,HUANUCO,HUAMALIES,202007,87,1,20,15,5
85,1005,HUANUCO,HUAMALIES,202008,130,4,13,26,-13
87,1005,HUANUCO,HUAMALIES,202009,82,4,23,19,4
88,1005,HUANUCO,HUAMALIES,202010,37,2,16,27,-11
89,1005,HUANUCO,HUAMALIES,202011,25,4,15,26,-11
90,1005,HUANUCO,HUAMALIES,202012,64,4,20,21,-1
73,1005,HUANUCO,HUAMALIES,202101,98,7,26,22,4
74,1005,HUANUCO,HUAMALIES,202102,120,14,32,17,15
76,1005,HUANUCO,HUAMALIES,202103,112,15,24,19,5
78,1005,HUANUCO,HUAMALIES,202104,196,22,48,19,29
80,1005,HUANUCO,HUAMALIES,202105,113,8,30,18,12
82,1005,HUANUCO,HUAMALIES,202106,42,8,27,22,5
84,1005,HUANUCO,HUAMALIES,202107,48,1,18,15,3
86,1005,HUANUCO,HUAMALIES,202108,20,1,20,26,-6
93,1006,HUANUCO,LEONCIO PRADO,202003,0,0,36,51,-15
95,1006,HUANUCO,LEONCIO PRADO,202004,20,1,35,37,-2
97,1006,HUANUCO,LEONCIO PRADO,202005,40,12,43,39,4
99,1006,HUANUCO,LEONCIO PRADO,202006,138,61,107,31,76
101,1006,HUANUCO,LEONCIO PRADO,202007,322,116,154,45,109
103,1006,HUANUCO,LEONCIO PRADO,202008,776,58,77,41,36
105,1006,HUANUCO,LEONCIO PRADO,202009,146,12,44,32,12
106,1006,HUANUCO,LEONCIO PRADO,202010,89,15,53,37,16
107,1006,HUANUCO,LEONCIO PRADO,202011,54,7,44,38,6
108,1006,HUANUCO,LEONCIO PRADO,202012,75,3,44,42,2
91,1006,HUANUCO,LEONCIO PRADO,202101,121,44,72,45,27
92,1006,HUANUCO,LEONCIO PRADO,202102,155,44,70,25,45
94,1006,HUANUCO,LEONCIO PRADO,202103,132,23,79,51,28
96,1006,HUANUCO,LEONCIO PRADO,202104,265,42,77,37,40
98,1006,HUANUCO,LEONCIO PRADO,202105,141,49,101,39,62
100,1006,HUANUCO,LEONCIO PRADO,202106,103,37,82,31,51
102,1006,HUANUCO,LEONCIO PRADO,202107,81,11,70,45,25
104,1006,HUANUCO,LEONCIO PRADO,202108,28,2,45,41,4
111,1007,HUANUCO,MARAÑON,202003,0,0,4,11,-7
113,1007,HUANUCO,MARAÑON,202004,0,0,10,8,2
115,1007,HUANUCO,MARAÑON,202005,3,2,13,11,2
117,1007,HUANUCO,MARAÑON,202006,16,1,4,6,-2
119,1007,HUANUCO,MARAÑON,202007,48,1,10,11,-1
121,1007,HUANUCO,MARAÑON,202008,91,3,16,2,14
123,1007,HUANUCO,MARAÑON,202009,44,2,8,8,0
124,1007,HUANUCO,MARAÑON,202010,39,1,12,11,1
125,1007,HUANUCO,MARAÑON,202011,18,2,13,5,8
126,1007,HUANUCO,MARAÑON,202012,29,1,9,6,3
109,1007,HUANUCO,MARAÑON,202101,25,4,11,12,-1
110,1007,HUANUCO,MARAÑON,202102,23,1,11,4,7
112,1007,HUANUCO,MARAÑON,202103,11,2,15,11,4
114,1007,HUANUCO,MARAÑON,202104,1,7,20,8,12
116,1007,HUANUCO,MARAÑON,202105,0,7,26,11,15
118,1007,HUANUCO,MARAÑON,202106,0,1,10,6,4
120,1007,HUANUCO,MARAÑON,202107,0,1,13,11,2
122,1007,HUANUCO,MARAÑON,202108,0,1,14,2,12
129,1008,HUANUCO,PACHITEA,202003,0,0,17,19,-2
131,1008,HUANUCO,PACHITEA,202004,8,0,10,7,3
133,1008,HUANUCO,PACHITEA,202005,12,0,13,11,2
135,1008,HUANUCO,PACHITEA,202006,25,2,18,6,12
137,1008,HUANUCO,PACHITEA,202007,61,4,23,7,16
139,1008,HUANUCO,PACHITEA,202008,129,6,27,14,13
141,1008,HUANUCO,PACHITEA,202009,81,2,18,15,3
142,1008,HUANUCO,PACHITEA,202010,17,4,23,7,16
143,1008,HUANUCO,PACHITEA,202011,25,4,13,16,-3
144,1008,HUANUCO,PACHITEA,202012,27,3,21,5,16
127,1008,HUANUCO,PACHITEA,202101,40,11,32,12,20
128,1008,HUANUCO,PACHITEA,202102,32,9,27,21,6
130,1008,HUANUCO,PACHITEA,202103,20,1,12,19,-7
132,1008,HUANUCO,PACHITEA,202104,30,2,17,7,10
134,1008,HUANUCO,PACHITEA,202105,52,3,18,11,7
136,1008,HUANUCO,PACHITEA,202106,11,4,25,6,19
138,1008,HUANUCO,PACHITEA,202107,6,0,28,7,21
140,1008,HUANUCO,PACHITEA,202108,9,2,14,14,0
147,1009,HUANUCO,PUERTO INCA,202003,0,0,7,3,4
149,1009,HUANUCO,PUERTO INCA,202004,2,1,7,4,3
151,1009,HUANUCO,PUERTO INCA,202005,49,1,2,3,-1
153,1009,HUANUCO,PUERTO INCA,202006,154,1,4,7,-3
155,1009,HUANUCO,PUERTO INCA,202007,184,6,8,2,6
157,1009,HUANUCO,PUERTO INCA,202008,536,6,9,6,3
159,1009,HUANUCO,PUERTO INCA,202009,138,4,14,3,11
160,1009,HUANUCO,PUERTO INCA,202010,64,1,5,4,1
161,1009,HUANUCO,PUERTO INCA,202011,51,3,3,8,-5
162,1009,HUANUCO,PUERTO INCA,202012,43,2,7,6,1
145,1009,HUANUCO,PUERTO INCA,202101,90,2,9,6,3
146,1009,HUANUCO,PUERTO INCA,202102,136,1,6,3,3
148,1009,HUANUCO,PUERTO INCA,202103,414,6,12,3,9
150,1009,HUANUCO,PUERTO INCA,202104,444,15,20,4,16
152,1009,HUANUCO,PUERTO INCA,202105,154,4,12,3,9
154,1009,HUANUCO,PUERTO INCA,202106,61,3,10,7,3
156,1009,HUANUCO,PUERTO INCA,202107,37,0,9,2,7
158,1009,HUANUCO,PUERTO INCA,202108,22,0,8,6,2
183,1010,HUANUCO,LAURICOCHA,202003,0,0,10,6,4
185,1010,HUANUCO,LAURICOCHA,202004,4,0,4,3,1
187,1010,HUANUCO,LAURICOCHA,202005,4,0,2,4,-2
189,1010,HUANUCO,LAURICOCHA,202006,8,3,10,4,6
191,1010,HUANUCO,LAURICOCHA,202007,15,0,7,5,2
193,1010,HUANUCO,LAURICOCHA,202008,14,1,9,5,4
195,1010,HUANUCO,LAURICOCHA,202009,9,3,8,5,3
196,1010,HUANUCO,LAURICOCHA,202010,3,0,4,3,1
197,1010,HUANUCO,LAURICOCHA,202011,1,0,6,5,1
198,1010,HUANUCO,LAURICOCHA,202012,2,0,5,6,-1
181,1010,HUANUCO,LAURICOCHA,202101,18,7,13,7,6
182,1010,HUANUCO,LAURICOCHA,202102,20,6,13,4,9
184,1010,HUANUCO,LAURICOCHA,202103,13,3,10,6,4
186,1010,HUANUCO,LAURICOCHA,202104,18,4,15,3,12
188,1010,HUANUCO,LAURICOCHA,202105,62,9,18,4,14
190,1010,HUANUCO,LAURICOCHA,202106,13,5,10,4,6
192,1010,HUANUCO,LAURICOCHA,202107,3,1,9,5,4
194,1010,HUANUCO,LAURICOCHA,202108,1,0,6,5,1
201,1011,HUANUCO,YAROWILCA,202003,0,0,13,7,6
203,1011,HUANUCO,YAROWILCA,202004,1,0,7,8,-1
205,1011,HUANUCO,YAROWILCA,202005,4,2,19,7,12
207,1011,HUANUCO,YAROWILCA,202006,24,3,10,12,-2
209,1011,HUANUCO,YAROWILCA,202007,35,3,17,9,8
211,1011,HUANUCO,YAROWILCA,202008,36,0,9,12,-3
213,1011,HUANUCO,YAROWILCA,202009,21,2,16,12,4
214,1011,HUANUCO,YAROWILCA,202010,17,1,15,15,0
215,1011,HUANUCO,YAROWILCA,202011,8,0,14,6,8
216,1011,HUANUCO,YAROWILCA,202012,8,0,5,6,-1
199,1011,HUANUCO,YAROWILCA,202101,28,7,26,20,6
200,1011,HUANUCO,YAROWILCA,202102,40,8,22,15,7
202,1011,HUANUCO,YAROWILCA,202103,13,3,11,7,4
204,1011,HUANUCO,YAROWILCA,202104,31,3,16,8,8
206,1011,HUANUCO,YAROWILCA,202105,44,2,12,7,5
208,1011,HUANUCO,YAROWILCA,202106,5,3,14,12,2
210,1011,HUANUCO,YAROWILCA,202107,3,0,13,9,4
212,1011,HUANUCO,YAROWILCA,202108,2,2,14,12,2
327,1101,ICA,ICA,202003,4,1,144,189,-45
329,1101,ICA,ICA,202004,318,42,192,176,16
331,1101,ICA,ICA,202005,942,126,298,157,141
333,1101,ICA,ICA,202006,1888,236,422,159,263
335,1101,ICA,ICA,202007,3132,406,607,176,431
337,1101,ICA,ICA,202008,4590,343,465,174,291
339,1101,ICA,ICA,202009,2896,171,276,209,67
340,1101,ICA,ICA,202010,691,74,190,175,15
341,1101,ICA,ICA,202011,247,33,177,151,26
342,1101,ICA,ICA,202012,541,90,223,170,53
325,1101,ICA,ICA,202101,2625,319,472,183,289
326,1101,ICA,ICA,202102,2787,554,669,167,502
328,1101,ICA,ICA,202103,1788,295,452,189,263
330,1101,ICA,ICA,202104,2117,282,400,176,224
332,1101,ICA,ICA,202105,1520,284,409,157,252
334,1101,ICA,ICA,202106,1033,146,287,159,128
336,1101,ICA,ICA,202107,537,89,237,176,61
338,1101,ICA,ICA,202108,443,41,164,174,-10
345,1102,ICA,CHINCHA,202003,3,1,93,114,-21
347,1102,ICA,CHINCHA,202004,158,42,123,90,33
349,1102,ICA,CHINCHA,202005,1099,235,377,101,276
351,1102,ICA,CHINCHA,202006,781,412,532,125,407
353,1102,ICA,CHINCHA,202007,986,252,323,88,235
355,1102,ICA,CHINCHA,202008,1410,130,216,88,128
357,1102,ICA,CHINCHA,202009,912,65,146,86,60
358,1102,ICA,CHINCHA,202010,180,38,114,101,13
359,1102,ICA,CHINCHA,202011,131,37,109,95,14
360,1102,ICA,CHINCHA,202012,205,37,109,89,20
343,1102,ICA,CHINCHA,202101,789,128,201,79,122
344,1102,ICA,CHINCHA,202102,862,236,310,116,194
346,1102,ICA,CHINCHA,202103,682,240,319,114,205
348,1102,ICA,CHINCHA,202104,748,283,342,90,252
350,1102,ICA,CHINCHA,202105,844,266,337,101,236
352,1102,ICA,CHINCHA,202106,389,109,181,125,56
354,1102,ICA,CHINCHA,202107,187,40,138,88,50
356,1102,ICA,CHINCHA,202108,193,22,98,88,10
363,1103,ICA,NASCA,202003,0,0,29,40,-11
365,1103,ICA,NASCA,202004,69,4,32,30,2
367,1103,ICA,NASCA,202005,364,17,40,38,2
369,1103,ICA,NASCA,202006,328,21,53,33,20
371,1103,ICA,NASCA,202007,313,48,99,23,76
373,1103,ICA,NASCA,202008,515,76,112,39,73
375,1103,ICA,NASCA,202009,621,41,56,38,18
376,1103,ICA,NASCA,202010,166,25,53,32,21
377,1103,ICA,NASCA,202011,56,11,28,32,-4
378,1103,ICA,NASCA,202012,37,11,38,26,12
361,1103,ICA,NASCA,202101,134,32,60,26,34
362,1103,ICA,NASCA,202102,358,68,96,31,65
364,1103,ICA,NASCA,202103,231,61,93,40,53
366,1103,ICA,NASCA,202104,273,103,134,30,104
368,1103,ICA,NASCA,202105,221,65,92,38,54
370,1103,ICA,NASCA,202106,87,35,57,33,24
372,1103,ICA,NASCA,202107,65,20,45,23,22
374,1103,ICA,NASCA,202108,80,14,37,39,-2
381,1104,ICA,PALPA,202003,0,1,8,7,1
383,1104,ICA,PALPA,202004,75,6,9,2,7
385,1104,ICA,PALPA,202005,138,6,9,7,2
387,1104,ICA,PALPA,202006,136,2,9,8,1
389,1104,ICA,PALPA,202007,203,10,15,12,3
391,1104,ICA,PALPA,202008,291,16,25,6,19
393,1104,ICA,PALPA,202009,223,17,18,6,12
394,1104,ICA,PALPA,202010,43,6,14,11,3
395,1104,ICA,PALPA,202011,17,3,8,8,0
396,1104,ICA,PALPA,202012,20,2,11,7,4
379,1104,ICA,PALPA,202101,172,18,35,6,29
380,1104,ICA,PALPA,202102,84,8,15,8,7
382,1104,ICA,PALPA,202103,98,8,14,7,7
384,1104,ICA,PALPA,202104,180,14,20,2,18
386,1104,ICA,PALPA,202105,112,15,20,7,13
388,1104,ICA,PALPA,202106,59,7,12,8,4
390,1104,ICA,PALPA,202107,51,9,14,12,2
392,1104,ICA,PALPA,202108,14,0,10,6,4
399,1105,ICA,PISCO,202003,1,0,69,79,-10
401,1105,ICA,PISCO,202004,79,14,49,46,3
403,1105,ICA,PISCO,202005,529,37,103,73,30
405,1105,ICA,PISCO,202006,940,135,220,64,156
407,1105,ICA,PISCO,202007,1204,167,247,62,185
409,1105,ICA,PISCO,202008,1701,118,173,63,110
411,1105,ICA,PISCO,202009,939,55,107,83,24
412,1105,ICA,PISCO,202010,243,23,68,73,-5
413,1105,ICA,PISCO,202011,85,24,77,60,17
414,1105,ICA,PISCO,202012,136,24,89,59,30
397,1105,ICA,PISCO,202101,523,42,113,67,46
398,1105,ICA,PISCO,202102,726,110,155,64,91
400,1105,ICA,PISCO,202103,756,131,175,79,96
402,1105,ICA,PISCO,202104,848,186,253,46,207
404,1105,ICA,PISCO,202105,567,164,222,73,149
406,1105,ICA,PISCO,202106,371,88,157,64,93
408,1105,ICA,PISCO,202107,152,36,89,62,27
410,1105,ICA,PISCO,202108,191,20,73,63,10
417,1201,JUNIN,HUANCAYO,202003,16,1,252,220,32
419,1201,JUNIN,HUANCAYO,202004,247,20,207,194,13
421,1201,JUNIN,HUANCAYO,202005,623,46,250,215,35
423,1201,JUNIN,HUANCAYO,202006,1182,106,334,204,130
425,1201,JUNIN,HUANCAYO,202007,2490,507,804,245,559
427,1201,JUNIN,HUANCAYO,202008,4009,409,660,259,401
429,1201,JUNIN,HUANCAYO,202009,2270,145,336,237,99
430,1201,JUNIN,HUANCAYO,202010,1261,63,252,236,16
431,1201,JUNIN,HUANCAYO,202011,542,33,215,242,-27
432,1201,JUNIN,HUANCAYO,202012,1062,50,273,237,36
415,1201,JUNIN,HUANCAYO,202101,4149,302,584,236,348
416,1201,JUNIN,HUANCAYO,202102,4316,395,648,200,448
418,1201,JUNIN,HUANCAYO,202103,3182,246,469,220,249
420,1201,JUNIN,HUANCAYO,202104,5418,359,557,194,363
422,1201,JUNIN,HUANCAYO,202105,5889,478,711,215,496
424,1201,JUNIN,HUANCAYO,202106,3544,286,497,204,293
426,1201,JUNIN,HUANCAYO,202107,1676,93,330,245,85
428,1201,JUNIN,HUANCAYO,202108,1265,35,252,259,-7
435,1202,JUNIN,CONCEPCION,202003,0,0,30,28,2
437,1202,JUNIN,CONCEPCION,202004,9,1,22,24,-2
439,1202,JUNIN,CONCEPCION,202005,28,14,44,20,24
441,1202,JUNIN,CONCEPCION,202006,49,10,44,35,9
443,1202,JUNIN,CONCEPCION,202007,148,12,43,23,20
445,1202,JUNIN,CONCEPCION,202008,201,15,48,18,30
447,1202,JUNIN,CONCEPCION,202009,193,10,41,38,3
448,1202,JUNIN,CONCEPCION,202010,60,7,42,24,18
449,1202,JUNIN,CONCEPCION,202011,26,3,31,20,11
450,1202,JUNIN,CONCEPCION,202012,26,6,52,26,26
433,1202,JUNIN,CONCEPCION,202101,178,18,58,27,31
434,1202,JUNIN,CONCEPCION,202102,186,27,72,25,47
436,1202,JUNIN,CONCEPCION,202103,186,19,63,28,35
438,1202,JUNIN,CONCEPCION,202104,249,15,48,24,24
440,1202,JUNIN,CONCEPCION,202105,253,21,68,20,48
442,1202,JUNIN,CONCEPCION,202106,176,26,59,35,24
444,1202,JUNIN,CONCEPCION,202107,107,4,45,23,22
446,1202,JUNIN,CONCEPCION,202108,63,1,21,18,3
453,1203,JUNIN,CHANCHAMAYO,202003,0,1,63,54,9
455,1203,JUNIN,CHANCHAMAYO,202004,52,2,48,69,-21
457,1203,JUNIN,CHANCHAMAYO,202005,256,25,83,57,26
459,1203,JUNIN,CHANCHAMAYO,202006,417,56,111,62,49
461,1203,JUNIN,CHANCHAMAYO,202007,548,121,181,57,124
463,1203,JUNIN,CHANCHAMAYO,202008,797,70,121,65,56
465,1203,JUNIN,CHANCHAMAYO,202009,544,40,107,61,46
466,1203,JUNIN,CHANCHAMAYO,202010,480,17,66,74,-8
467,1203,JUNIN,CHANCHAMAYO,202011,376,14,70,53,17
468,1203,JUNIN,CHANCHAMAYO,202012,456,8,67,59,8
451,1203,JUNIN,CHANCHAMAYO,202101,551,45,107,78,29
452,1203,JUNIN,CHANCHAMAYO,202102,1141,121,167,48,119
454,1203,JUNIN,CHANCHAMAYO,202103,1049,87,146,54,92
456,1203,JUNIN,CHANCHAMAYO,202104,1639,121,180,69,111
458,1203,JUNIN,CHANCHAMAYO,202105,979,110,179,57,122
460,1203,JUNIN,CHANCHAMAYO,202106,322,47,95,62,33
462,1203,JUNIN,CHANCHAMAYO,202107,182,13,77,57,20
464,1203,JUNIN,CHANCHAMAYO,202108,154,4,61,65,-4
471,1204,JUNIN,JAUJA,202003,0,0,63,51,12
473,1204,JUNIN,JAUJA,202004,19,5,52,57,-5
475,1204,JUNIN,JAUJA,202005,55,7,60,48,12
477,1204,JUNIN,JAUJA,202006,45,6,59,43,16
479,1204,JUNIN,JAUJA,202007,135,28,83,64,19
481,1204,JUNIN,JAUJA,202008,262,31,93,40,53
483,1204,JUNIN,JAUJA,202009,109,16,64,51,13
484,1204,JUNIN,JAUJA,202010,97,7,58,50,8
485,1204,JUNIN,JAUJA,202011,59,4,47,67,-20
486,1204,JUNIN,JAUJA,202012,299,2,36,58,-22
469,1204,JUNIN,JAUJA,202101,375,39,109,65,44
470,1204,JUNIN,JAUJA,202102,485,57,128,33,95
472,1204,JUNIN,JAUJA,202103,610,44,103,51,52
474,1204,JUNIN,JAUJA,202104,979,92,164,57,107
476,1204,JUNIN,JAUJA,202105,844,105,170,48,122
478,1204,JUNIN,JAUJA,202106,359,56,129,43,86
480,1204,JUNIN,JAUJA,202107,121,13,75,64,11
482,1204,JUNIN,JAUJA,202108,91,5,51,40,11
489,1205,JUNIN,JUNIN,202003,0,0,9,20,-11
491,1205,JUNIN,JUNIN,202004,20,0,14,12,2
493,1205,JUNIN,JUNIN,202005,99,8,19,14,5
495,1205,JUNIN,JUNIN,202006,33,3,17,19,-2
497,1205,JUNIN,JUNIN,202007,41,3,25,12,13
499,1205,JUNIN,JUNIN,202008,127,5,20,18,2
501,1205,JUNIN,JUNIN,202009,76,6,14,10,4
502,1205,JUNIN,JUNIN,202010,22,1,9,14,-5
503,1205,JUNIN,JUNIN,202011,55,2,18,10,8
504,1205,JUNIN,JUNIN,202012,77,6,21,16,5
487,1205,JUNIN,JUNIN,202101,156,20,30,14,16
488,1205,JUNIN,JUNIN,202102,132,16,30,12,18
490,1205,JUNIN,JUNIN,202103,125,16,28,20,8
492,1205,JUNIN,JUNIN,202104,187,17,38,12,26
494,1205,JUNIN,JUNIN,202105,125,20,28,14,14
496,1205,JUNIN,JUNIN,202106,57,6,17,19,-2
498,1205,JUNIN,JUNIN,202107,27,2,13,12,1
500,1205,JUNIN,JUNIN,202108,19,1,10,18,-8
507,1206,JUNIN,SATIPO,202003,0,0,46,37,9
509,1206,JUNIN,SATIPO,202004,25,1,19,43,-24
511,1206,JUNIN,SATIPO,202005,103,3,53,49,4
513,1206,JUNIN,SATIPO,202006,159,10,41,46,-5
515,1206,JUNIN,SATIPO,202007,258,21,78,38,40
517,1206,JUNIN,SATIPO,202008,923,48,84,43,41
519,1206,JUNIN,SATIPO,202009,517,20,63,57,6
520,1206,JUNIN,SATIPO,202010,893,10,67,49,18
521,1206,JUNIN,SATIPO,202011,694,7,56,45,11
522,1206,JUNIN,SATIPO,202012,569,8,57,43,14
505,1206,JUNIN,SATIPO,202101,849,34,92,40,52
506,1206,JUNIN,SATIPO,202102,998,56,105,39,66
508,1206,JUNIN,SATIPO,202103,936,42,78,37,41
510,1206,JUNIN,SATIPO,202104,1426,51,83,43,40
512,1206,JUNIN,SATIPO,202105,1087,55,97,49,48
514,1206,JUNIN,SATIPO,202106,769,38,71,46,25
516,1206,JUNIN,SATIPO,202107,401,12,60,38,22
518,1206,JUNIN,SATIPO,202108,258,6,45,43,2
525,1207,JUNIN,TARMA,202003,0,0,51,68,-17
527,1207,JUNIN,TARMA,202004,38,2,36,40,-4
529,1207,JUNIN,TARMA,202005,99,10,66,47,19
531,1207,JUNIN,TARMA,202006,55,8,53,49,4
533,1207,JUNIN,TARMA,202007,139,22,93,53,40
535,1207,JUNIN,TARMA,202008,383,41,89,51,38
537,1207,JUNIN,TARMA,202009,225,26,72,51,21
538,1207,JUNIN,TARMA,202010,171,15,79,42,37
539,1207,JUNIN,TARMA,202011,70,10,70,46,24
540,1207,JUNIN,TARMA,202012,65,7,52,47,5
523,1207,JUNIN,TARMA,202101,261,38,99,64,35
524,1207,JUNIN,TARMA,202102,653,104,187,44,143
526,1207,JUNIN,TARMA,202103,652,80,173,68,105
528,1207,JUNIN,TARMA,202104,813,86,175,40,135
530,1207,JUNIN,TARMA,202105,508,76,145,47,98
532,1207,JUNIN,TARMA,202106,249,30,82,49,33
534,1207,JUNIN,TARMA,202107,102,10,75,53,22
536,1207,JUNIN,TARMA,202108,103,9,60,51,9
543,1208,JUNIN,YAULI,202003,0,0,12,14,-2
545,1208,JUNIN,YAULI,202004,31,3,10,13,-3
547,1208,JUNIN,YAULI,202005,107,9,22,14,8
549,1208,JUNIN,YAULI,202006,151,20,35,21,14
551,1208,JUNIN,YAULI,202007,189,20,38,17,21
553,1208,JUNIN,YAULI,202008,281,13,20,7,13
555,1208,JUNIN,YAULI,202009,260,9,15,16,-1
556,1208,JUNIN,YAULI,202010,66,7,20,13,7
557,1208,JUNIN,YAULI,202011,43,4,10,10,0
558,1208,JUNIN,YAULI,202012,54,8,8,16,-8
541,1208,JUNIN,YAULI,202101,212,26,42,10,32
542,1208,JUNIN,YAULI,202102,264,35,40,9,31
544,1208,JUNIN,YAULI,202103,270,31,38,14,24
546,1208,JUNIN,YAULI,202104,409,42,42,13,29
548,1208,JUNIN,YAULI,202105,222,53,62,14,48
550,1208,JUNIN,YAULI,202106,66,26,35,21,14
552,1208,JUNIN,YAULI,202107,29,9,22,17,5
554,1208,JUNIN,YAULI,202108,17,6,17,7,10
561,1209,JUNIN,CHUPACA,202003,0,0,24,23,1
563,1209,JUNIN,CHUPACA,202004,46,6,27,21,6
565,1209,JUNIN,CHUPACA,202005,113,14,44,21,23
567,1209,JUNIN,CHUPACA,202006,71,5,31,25,6
569,1209,JUNIN,CHUPACA,202007,286,22,48,32,16
571,1209,JUNIN,CHUPACA,202008,439,28,68,16,52
573,1209,JUNIN,CHUPACA,202009,277,11,35,27,8
574,1209,JUNIN,CHUPACA,202010,216,7,31,25,6
575,1209,JUNIN,CHUPACA,202011,120,2,22,33,-11
576,1209,JUNIN,CHUPACA,202012,162,6,24,40,-16
559,1209,JUNIN,CHUPACA,202101,197,15,41,29,12
560,1209,JUNIN,CHUPACA,202102,329,36,61,30,31
562,1209,JUNIN,CHUPACA,202103,297,30,61,23,38
564,1209,JUNIN,CHUPACA,202104,382,33,61,21,40
566,1209,JUNIN,CHUPACA,202105,449,41,76,21,55
568,1209,JUNIN,CHUPACA,202106,248,19,44,25,19
570,1209,JUNIN,CHUPACA,202107,121,4,23,32,-9
572,1209,JUNIN,CHUPACA,202108,142,10,31,16,15
579,1301,LA LIBERTAD,TRUJILLO,202003,29,4,396,405,-9
581,1301,LA LIBERTAD,TRUJILLO,202004,769,50,391,358,33
583,1301,LA LIBERTAD,TRUJILLO,202005,2936,241,673,366,307
585,1301,LA LIBERTAD,TRUJILLO,202006,3806,1103,1801,397,1404
587,1301,LA LIBERTAD,TRUJILLO,202007,4355,885,1504,415,1089
589,1301,LA LIBERTAD,TRUJILLO,202008,4851,391,791,443,348
591,1301,LA LIBERTAD,TRUJILLO,202009,4015,201,510,405,105
592,1301,LA LIBERTAD,TRUJILLO,202010,2065,100,465,426,39
593,1301,LA LIBERTAD,TRUJILLO,202011,1216,89,483,400,83
594,1301,LA LIBERTAD,TRUJILLO,202012,1287,146,588,423,165
577,1301,LA LIBERTAD,TRUJILLO,202101,2453,327,787,417,370
578,1301,LA LIBERTAD,TRUJILLO,202102,4403,476,905,402,503
580,1301,LA LIBERTAD,TRUJILLO,202103,7316,656,1163,405,758
582,1301,LA LIBERTAD,TRUJILLO,202104,9430,1072,1649,358,1291
584,1301,LA LIBERTAD,TRUJILLO,202105,9205,747,1278,366,912
586,1301,LA LIBERTAD,TRUJILLO,202106,2344,240,665,397,268
588,1301,LA LIBERTAD,TRUJILLO,202107,1551,64,483,415,68
590,1301,LA LIBERTAD,TRUJILLO,202108,720,27,448,443,5
597,1302,LA LIBERTAD,ASCOPE,202003,0,0,43,61,-18
599,1302,LA LIBERTAD,ASCOPE,202004,44,6,39,63,-24
601,1302,LA LIBERTAD,ASCOPE,202005,173,28,71,55,16
603,1302,LA LIBERTAD,ASCOPE,202006,325,131,174,61,113
605,1302,LA LIBERTAD,ASCOPE,202007,354,157,222,56,166
607,1302,LA LIBERTAD,ASCOPE,202008,673,92,116,62,54
609,1302,LA LIBERTAD,ASCOPE,202009,530,38,79,68,11
610,1302,LA LIBERTAD,ASCOPE,202010,41,16,45,52,-7
611,1302,LA LIBERTAD,ASCOPE,202011,36,9,45,45,0
612,1302,LA LIBERTAD,ASCOPE,202012,30,16,70,53,17
595,1302,LA LIBERTAD,ASCOPE,202101,80,32,78,62,16
596,1302,LA LIBERTAD,ASCOPE,202102,289,38,86,77,9
598,1302,LA LIBERTAD,ASCOPE,202103,253,79,133,61,72
600,1302,LA LIBERTAD,ASCOPE,202104,203,86,128,63,65
602,1302,LA LIBERTAD,ASCOPE,202105,106,62,121,55,66
604,1302,LA LIBERTAD,ASCOPE,202106,36,32,83,61,22
606,1302,LA LIBERTAD,ASCOPE,202107,48,7,52,56,-4
608,1302,LA LIBERTAD,ASCOPE,202108,9,8,55,62,-7
615,1303,LA LIBERTAD,BOLIVAR,202003,0,0,2,7,-5
617,1303,LA LIBERTAD,BOLIVAR,202004,0,0,1,6,-5
619,1303,LA LIBERTAD,BOLIVAR,202005,0,0,3,7,-4
621,1303,LA LIBERTAD,BOLIVAR,202006,0,0,2,4,-2
623,1303,LA LIBERTAD,BOLIVAR,202007,3,0,5,2,3
625,1303,LA LIBERTAD,BOLIVAR,202008,5,1,1,5,-4
627,1303,LA LIBERTAD,BOLIVAR,202009,3,0,1,2,-1
628,1303,LA LIBERTAD,BOLIVAR,202010,2,0,0,6,-6
629,1303,LA LIBERTAD,BOLIVAR,202011,2,0,4,7,-3
630,1303,LA LIBERTAD,BOLIVAR,202012,3,1,8,2,6
613,1303,LA LIBERTAD,BOLIVAR,202101,0,0,5,5,0
614,1303,LA LIBERTAD,BOLIVAR,202102,4,3,9,3,6
616,1303,LA LIBERTAD,BOLIVAR,202103,29,2,8,7,1
618,1303,LA LIBERTAD,BOLIVAR,202104,72,9,14,6,8
620,1303,LA LIBERTAD,BOLIVAR,202105,31,1,4,7,-3
622,1303,LA LIBERTAD,BOLIVAR,202106,8,2,7,4,3
624,1303,LA LIBERTAD,BOLIVAR,202107,4,1,5,2,3
626,1303,LA LIBERTAD,BOLIVAR,202108,1,0,1,5,-4
633,1304,LA LIBERTAD,CHEPEN,202003,0,0,23,38,-15
635,1304,LA LIBERTAD,CHEPEN,202004,138,15,21,26,-5
637,1304,LA LIBERTAD,CHEPEN,202005,344,80,62,23,39
639,1304,LA LIBERTAD,CHEPEN,202006,613,62,48,25,23
641,1304,LA LIBERTAD,CHEPEN,202007,246,72,63,33,30
643,1304,LA LIBERTAD,CHEPEN,202008,392,62,49,41,8
645,1304,LA LIBERTAD,CHEPEN,202009,276,21,22,29,-7
646,1304,LA LIBERTAD,CHEPEN,202010,246,10,16,53,-37
647,1304,LA LIBERTAD,CHEPEN,202011,105,21,29,43,-14
648,1304,LA LIBERTAD,CHEPEN,202012,26,14,38,40,-2
631,1304,LA LIBERTAD,CHEPEN,202101,55,19,37,45,-8
632,1304,LA LIBERTAD,CHEPEN,202102,177,48,76,34,42
634,1304,LA LIBERTAD,CHEPEN,202103,280,65,120,38,82
636,1304,LA LIBERTAD,CHEPEN,202104,339,82,124,26,98
638,1304,LA LIBERTAD,CHEPEN,202105,246,68,113,23,90
640,1304,LA LIBERTAD,CHEPEN,202106,135,24,60,25,35
642,1304,LA LIBERTAD,CHEPEN,202107,77,11,39,33,6
644,1304,LA LIBERTAD,CHEPEN,202108,60,6,38,41,-3
651,1305,LA LIBERTAD,JULCAN,202003,0,0,10,11,-1
653,1305,LA LIBERTAD,JULCAN,202004,0,0,7,6,1
655,1305,LA LIBERTAD,JULCAN,202005,4,0,8,8,0
657,1305,LA LIBERTAD,JULCAN,202006,4,0,8,13,-5
659,1305,LA LIBERTAD,JULCAN,202007,28,1,12,4,8
661,1305,LA LIBERTAD,JULCAN,202008,18,1,7,3,4
663,1305,LA LIBERTAD,JULCAN,202009,13,4,7,5,2
664,1305,LA LIBERTAD,JULCAN,202010,12,0,2,5,-3
665,1305,LA LIBERTAD,JULCAN,202011,30,0,7,8,-1
666,1305,LA LIBERTAD,JULCAN,202012,23,1,7,7,0
649,1305,LA LIBERTAD,JULCAN,202101,51,3,14,7,7
650,1305,LA LIBERTAD,JULCAN,202102,40,2,14,10,4
652,1305,LA LIBERTAD,JULCAN,202103,39,5,23,11,12
654,1305,LA LIBERTAD,JULCAN,202104,53,6,17,6,11
656,1305,LA LIBERTAD,JULCAN,202105,88,7,21,8,13
658,1305,LA LIBERTAD,JULCAN,202106,52,3,10,13,-3
660,1305,LA LIBERTAD,JULCAN,202107,21,1,8,4,4
662,1305,LA LIBERTAD,JULCAN,202108,1,0,12,3,9
669,1306,LA LIBERTAD,OTUZCO,202003,0,0,23,30,-7
671,1306,LA LIBERTAD,OTUZCO,202004,0,4,22,33,-11
673,1306,LA LIBERTAD,OTUZCO,202005,26,1,35,32,3
675,1306,LA LIBERTAD,OTUZCO,202006,92,10,66,26,40
677,1306,LA LIBERTAD,OTUZCO,202007,156,14,42,37,5
679,1306,LA LIBERTAD,OTUZCO,202008,178,14,44,26,18
681,1306,LA LIBERTAD,OTUZCO,202009,176,15,51,39,12
682,1306,LA LIBERTAD,OTUZCO,202010,123,10,51,28,23
683,1306,LA LIBERTAD,OTUZCO,202011,58,7,38,24,14
684,1306,LA LIBERTAD,OTUZCO,202012,53,5,32,35,-3
667,1306,LA LIBERTAD,OTUZCO,202101,54,3,47,30,17
668,1306,LA LIBERTAD,OTUZCO,202102,131,12,43,25,18
670,1306,LA LIBERTAD,OTUZCO,202103,157,11,67,30,37
672,1306,LA LIBERTAD,OTUZCO,202104,229,22,69,33,36
674,1306,LA LIBERTAD,OTUZCO,202105,239,18,79,32,47
676,1306,LA LIBERTAD,OTUZCO,202106,108,11,58,26,32
678,1306,LA LIBERTAD,OTUZCO,202107,125,7,44,37,7
680,1306,LA LIBERTAD,OTUZCO,202108,63,0,39,26,13
687,1307,LA LIBERTAD,PACASMAYO,202003,0,0,33,28,5
689,1307,LA LIBERTAD,PACASMAYO,202004,23,4,31,32,-1
691,1307,LA LIBERTAD,PACASMAYO,202005,105,18,54,36,18
693,1307,LA LIBERTAD,PACASMAYO,202006,189,58,61,41,20
695,1307,LA LIBERTAD,PACASMAYO,202007,193,71,106,41,65
697,1307,LA LIBERTAD,PACASMAYO,202008,365,91,110,52,58
699,1307,LA LIBERTAD,PACASMAYO,202009,356,34,58,33,25
700,1307,LA LIBERTAD,PACASMAYO,202010,162,11,39,42,-3
701,1307,LA LIBERTAD,PACASMAYO,202011,95,11,37,42,-5
702,1307,LA LIBERTAD,PACASMAYO,202012,107,21,56,37,19
685,1307,LA LIBERTAD,PACASMAYO,202101,202,41,80,35,45
686,1307,LA LIBERTAD,PACASMAYO,202102,339,52,95,38,57
688,1307,LA LIBERTAD,PACASMAYO,202103,645,80,131,28,103
690,1307,LA LIBERTAD,PACASMAYO,202104,696,89,153,32,121
692,1307,LA LIBERTAD,PACASMAYO,202105,449,68,104,36,68
694,1307,LA LIBERTAD,PACASMAYO,202106,254,35,73,41,32
696,1307,LA LIBERTAD,PACASMAYO,202107,123,7,58,41,17
698,1307,LA LIBERTAD,PACASMAYO,202108,100,6,41,52,-11
705,1308,LA LIBERTAD,PATAZ,202003,0,0,11,22,-11
707,1308,LA LIBERTAD,PATAZ,202004,3,0,8,15,-7
709,1308,LA LIBERTAD,PATAZ,202005,225,1,7,20,-13
711,1308,LA LIBERTAD,PATAZ,202006,52,8,12,24,-12
713,1308,LA LIBERTAD,PATAZ,202007,30,8,23,22,1
715,1308,LA LIBERTAD,PATAZ,202008,119,16,28,18,10
717,1308,LA LIBERTAD,PATAZ,202009,131,8,23,19,4
718,1308,LA LIBERTAD,PATAZ,202010,129,4,21,13,8
719,1308,LA LIBERTAD,PATAZ,202011,53,1,15,10,5
720,1308,LA LIBERTAD,PATAZ,202012,23,1,13,15,-2
703,1308,LA LIBERTAD,PATAZ,202101,73,6,23,16,7
704,1308,LA LIBERTAD,PATAZ,202102,76,4,22,15,7
706,1308,LA LIBERTAD,PATAZ,202103,74,2,26,22,4
708,1308,LA LIBERTAD,PATAZ,202104,188,9,37,15,22
710,1308,LA LIBERTAD,PATAZ,202105,82,13,31,20,11
712,1308,LA LIBERTAD,PATAZ,202106,31,5,23,24,-1
714,1308,LA LIBERTAD,PATAZ,202107,23,4,12,22,-10
716,1308,LA LIBERTAD,PATAZ,202108,29,2,17,18,-1
723,1309,LA LIBERTAD,SANCHEZ CARRION,202003,0,0,28,47,-19
725,1309,LA LIBERTAD,SANCHEZ CARRION,202004,1,1,22,31,-9
727,1309,LA LIBERTAD,SANCHEZ CARRION,202005,39,1,28,27,1
729,1309,LA LIBERTAD,SANCHEZ CARRION,202006,101,2,32,35,-3
731,1309,LA LIBERTAD,SANCHEZ CARRION,202007,183,10,47,37,10
733,1309,LA LIBERTAD,SANCHEZ CARRION,202008,193,24,55,23,32
735,1309,LA LIBERTAD,SANCHEZ CARRION,202009,862,8,23,45,-22
736,1309,LA LIBERTAD,SANCHEZ CARRION,202010,100,3,28,27,1
737,1309,LA LIBERTAD,SANCHEZ CARRION,202011,106,3,38,34,4
738,1309,LA LIBERTAD,SANCHEZ CARRION,202012,46,2,24,35,-11
721,1309,LA LIBERTAD,SANCHEZ CARRION,202101,66,6,44,35,9
722,1309,LA LIBERTAD,SANCHEZ CARRION,202102,153,7,32,29,3
724,1309,LA LIBERTAD,SANCHEZ CARRION,202103,326,12,39,47,-8
726,1309,LA LIBERTAD,SANCHEZ CARRION,202104,593,38,69,31,38
728,1309,LA LIBERTAD,SANCHEZ CARRION,202105,429,50,90,27,63
730,1309,LA LIBERTAD,SANCHEZ CARRION,202106,181,9,44,35,9
732,1309,LA LIBERTAD,SANCHEZ CARRION,202107,78,3,37,37,0
734,1309,LA LIBERTAD,SANCHEZ CARRION,202108,37,4,37,23,14
741,1310,LA LIBERTAD,SANTIAGO DE CHUCO,202003,0,0,5,23,-18
743,1310,LA LIBERTAD,SANTIAGO DE CHUCO,202004,0,0,12,13,-1
745,1310,LA LIBERTAD,SANTIAGO DE CHUCO,202005,15,2,10,13,-3
747,1310,LA LIBERTAD,SANTIAGO DE CHUCO,202006,33,3,10,15,-5
749,1310,LA LIBERTAD,SANTIAGO DE CHUCO,202007,110,14,21,16,5
751,1310,LA LIBERTAD,SANTIAGO DE CHUCO,202008,130,5,18,18,0
753,1310,LA LIBERTAD,SANTIAGO DE CHUCO,202009,61,7,20,20,0
754,1310,LA LIBERTAD,SANTIAGO DE CHUCO,202010,86,3,15,24,-9
755,1310,LA LIBERTAD,SANTIAGO DE CHUCO,202011,42,3,11,14,-3
756,1310,LA LIBERTAD,SANTIAGO DE CHUCO,202012,56,2,16,25,-9
739,1310,LA LIBERTAD,SANTIAGO DE CHUCO,202101,52,4,21,20,1
740,1310,LA LIBERTAD,SANTIAGO DE CHUCO,202102,65,2,24,18,6
742,1310,LA LIBERTAD,SANTIAGO DE CHUCO,202103,100,10,33,23,10
744,1310,LA LIBERTAD,SANTIAGO DE CHUCO,202104,173,19,46,13,33
746,1310,LA LIBERTAD,SANTIAGO DE CHUCO,202105,108,18,48,13,35
748,1310,LA LIBERTAD,SANTIAGO DE CHUCO,202106,41,8,29,15,14
750,1310,LA LIBERTAD,SANTIAGO DE CHUCO,202107,20,1,18,16,2
752,1310,LA LIBERTAD,SANTIAGO DE CHUCO,202108,17,2,17,18,-1
759,1311,LA LIBERTAD,GRAN CHIMU,202003,0,0,11,9,2
761,1311,LA LIBERTAD,GRAN CHIMU,202004,3,0,1,15,-14
763,1311,LA LIBERTAD,GRAN CHIMU,202005,4,0,8,13,-5
765,1311,LA LIBERTAD,GRAN CHIMU,202006,31,2,12,12,0
767,1311,LA LIBERTAD,GRAN CHIMU,202007,73,5,19,12,7
769,1311,LA LIBERTAD,GRAN CHIMU,202008,173,11,17,14,3
771,1311,LA LIBERTAD,GRAN CHIMU,202009,114,6,15,7,8
772,1311,LA LIBERTAD,GRAN CHIMU,202010,57,4,10,11,-1
773,1311,LA LIBERTAD,GRAN CHIMU,202011,37,2,11,14,-3
774,1311,LA LIBERTAD,GRAN CHIMU,202012,15,3,6,11,-5
757,1311,LA LIBERTAD,GRAN CHIMU,202101,21,2,9,11,-2
758,1311,LA LIBERTAD,GRAN CHIMU,202102,59,3,9,9,0
760,1311,LA LIBERTAD,GRAN CHIMU,202103,102,2,10,9,1
762,1311,LA LIBERTAD,GRAN CHIMU,202104,123,6,9,15,-6
764,1311,LA LIBERTAD,GRAN CHIMU,202105,118,9,18,13,5
766,1311,LA LIBERTAD,GRAN CHIMU,202106,76,2,12,12,0
768,1311,LA LIBERTAD,GRAN CHIMU,202107,30,0,9,12,-3
770,1311,LA LIBERTAD,GRAN CHIMU,202108,19,1,8,14,-6
777,1312,LA LIBERTAD,VIRU,202003,0,0,25,27,-2
779,1312,LA LIBERTAD,VIRU,202004,82,0,28,29,-1
781,1312,LA LIBERTAD,VIRU,202005,197,12,38,32,6
783,1312,LA LIBERTAD,VIRU,202006,251,63,115,31,84
785,1312,LA LIBERTAD,VIRU,202007,172,96,170,36,134
787,1312,LA LIBERTAD,VIRU,202008,235,29,61,31,30
789,1312,LA LIBERTAD,VIRU,202009,267,6,37,29,8
790,1312,LA LIBERTAD,VIRU,202010,115,8,47,25,22
791,1312,LA LIBERTAD,VIRU,202011,66,7,34,34,0
792,1312,LA LIBERTAD,VIRU,202012,27,7,42,45,-3
775,1312,LA LIBERTAD,VIRU,202101,59,6,31,24,7
776,1312,LA LIBERTAD,VIRU,202102,139,16,42,27,15
778,1312,LA LIBERTAD,VIRU,202103,369,45,94,27,67
780,1312,LA LIBERTAD,VIRU,202104,425,58,109,29,80
782,1312,LA LIBERTAD,VIRU,202105,152,45,86,32,54
784,1312,LA LIBERTAD,VIRU,202106,36,11,51,31,20
786,1312,LA LIBERTAD,VIRU,202107,32,1,25,36,-11
788,1312,LA LIBERTAD,VIRU,202108,9,3,28,31,-3
795,1401,LAMBAYEQUE,CHICLAYO,202003,28,14,48,41,7
797,1401,LAMBAYEQUE,CHICLAYO,202004,2232,398,361,40,321
799,1401,LAMBAYEQUE,CHICLAYO,202005,3971,801,804,36,768
801,1401,LAMBAYEQUE,CHICLAYO,202006,3292,500,381,38,343
803,1401,LAMBAYEQUE,CHICLAYO,202007,2523,391,353,42,311
805,1401,LAMBAYEQUE,CHICLAYO,202008,3277,384,436,30,406
807,1401,LAMBAYEQUE,CHICLAYO,202009,2793,292,306,34,272
808,1401,LAMBAYEQUE,CHICLAYO,202010,1880,247,180,31,149
809,1401,LAMBAYEQUE,CHICLAYO,202011,1473,199,163,42,121
810,1401,LAMBAYEQUE,CHICLAYO,202012,1775,217,256,30,226
793,1401,LAMBAYEQUE,CHICLAYO,202101,1869,335,320,30,290
794,1401,LAMBAYEQUE,CHICLAYO,202102,2203,367,283,44,239
796,1401,LAMBAYEQUE,CHICLAYO,202103,3971,484,431,41,390
798,1401,LAMBAYEQUE,CHICLAYO,202104,6665,881,875,40,835
800,1401,LAMBAYEQUE,CHICLAYO,202105,3787,717,687,36,651
802,1401,LAMBAYEQUE,CHICLAYO,202106,1385,200,282,38,244
804,1401,LAMBAYEQUE,CHICLAYO,202107,882,71,159,42,117
806,1401,LAMBAYEQUE,CHICLAYO,202108,576,32,133,30,103
813,1402,LAMBAYEQUE,FERREÑAFE,202003,6,3,9,5,4
815,1402,LAMBAYEQUE,FERREÑAFE,202004,453,83,110,7,103
817,1402,LAMBAYEQUE,FERREÑAFE,202005,632,42,83,3,80
819,1402,LAMBAYEQUE,FERREÑAFE,202006,363,23,27,2,25
821,1402,LAMBAYEQUE,FERREÑAFE,202007,353,32,27,5,22
823,1402,LAMBAYEQUE,FERREÑAFE,202008,691,68,77,9,68
825,1402,LAMBAYEQUE,FERREÑAFE,202009,414,29,48,5,43
826,1402,LAMBAYEQUE,FERREÑAFE,202010,184,29,24,0,24
827,1402,LAMBAYEQUE,FERREÑAFE,202011,126,15,14,6,8
828,1402,LAMBAYEQUE,FERREÑAFE,202012,167,30,41,2,39
811,1402,LAMBAYEQUE,FERREÑAFE,202101,130,31,32,2,30
812,1402,LAMBAYEQUE,FERREÑAFE,202102,112,33,20,5,15
814,1402,LAMBAYEQUE,FERREÑAFE,202103,188,44,25,5,20
816,1402,LAMBAYEQUE,FERREÑAFE,202104,87,61,88,7,81
818,1402,LAMBAYEQUE,FERREÑAFE,202105,5,59,57,3,54
820,1402,LAMBAYEQUE,FERREÑAFE,202106,2,21,27,2,25
822,1402,LAMBAYEQUE,FERREÑAFE,202107,2,6,13,5,8
824,1402,LAMBAYEQUE,FERREÑAFE,202108,1,6,11,9,2
831,1403,LAMBAYEQUE,LAMBAYEQUE,202003,1,0,22,8,14
833,1403,LAMBAYEQUE,LAMBAYEQUE,202004,416,71,122,12,110
835,1403,LAMBAYEQUE,LAMBAYEQUE,202005,1527,255,382,15,367
837,1403,LAMBAYEQUE,LAMBAYEQUE,202006,1144,143,189,6,183
839,1403,LAMBAYEQUE,LAMBAYEQUE,202007,936,95,115,16,99
841,1403,LAMBAYEQUE,LAMBAYEQUE,202008,1129,68,140,4,136
843,1403,LAMBAYEQUE,LAMBAYEQUE,202009,833,61,110,4,106
844,1403,LAMBAYEQUE,LAMBAYEQUE,202010,400,43,48,18,30
845,1403,LAMBAYEQUE,LAMBAYEQUE,202011,273,45,49,21,28
846,1403,LAMBAYEQUE,LAMBAYEQUE,202012,157,47,85,10,75
829,1403,LAMBAYEQUE,LAMBAYEQUE,202101,399,35,62,6,56
830,1403,LAMBAYEQUE,LAMBAYEQUE,202102,488,60,72,10,62
832,1403,LAMBAYEQUE,LAMBAYEQUE,202103,720,109,121,8,113
834,1403,LAMBAYEQUE,LAMBAYEQUE,202104,1197,163,240,12,228
836,1403,LAMBAYEQUE,LAMBAYEQUE,202105,729,113,147,15,132
838,1403,LAMBAYEQUE,LAMBAYEQUE,202106,255,63,125,6,119
840,1403,LAMBAYEQUE,LAMBAYEQUE,202107,195,22,63,16,47
842,1403,LAMBAYEQUE,LAMBAYEQUE,202108,81,17,45,4,41
849,1501,LIMA,LIMA,202003,972,82,3600,2551,1049
851,1501,LIMA,LIMA,202004,26912,2452,5651,2346,3305
853,1501,LIMA,LIMA,202005,72585,7418,11478,2322,9156
855,1501,LIMA,LIMA,202006,49614,7702,11706,2491,9215
857,1501,LIMA,LIMA,202007,49566,6981,10635,2663,7972
859,1501,LIMA,LIMA,202008,77638,6803,10516,2820,7696
861,1501,LIMA,LIMA,202009,50642,3482,6410,2697,3713
862,1501,LIMA,LIMA,202010,30127,1754,4710,2941,1769
863,1501,LIMA,LIMA,202011,15705,1048,3904,2816,1088
864,1501,LIMA,LIMA,202012,15612,1219,4311,2786,1525
847,1501,LIMA,LIMA,202101,58065,4635,8283,2545,5738
848,1501,LIMA,LIMA,202102,91452,9057,12859,2484,10375
850,1501,LIMA,LIMA,202103,97888,10525,14580,2551,12029
852,1501,LIMA,LIMA,202104,79116,9517,13018,2346,10672
854,1501,LIMA,LIMA,202105,37640,5116,8385,2322,6063
856,1501,LIMA,LIMA,202106,20211,1811,5302,2491,2811
858,1501,LIMA,LIMA,202107,12919,857,4611,2663,1948
860,1501,LIMA,LIMA,202108,10243,437,3895,2820,1075
867,1502,LIMA,BARRANCA,202003,1,1,31,15,16
869,1502,LIMA,BARRANCA,202004,47,4,37,19,18
871,1502,LIMA,BARRANCA,202005,159,15,43,18,25
873,1502,LIMA,BARRANCA,202006,646,61,89,55,34
875,1502,LIMA,BARRANCA,202007,1306,190,226,60,166
877,1502,LIMA,BARRANCA,202008,1275,137,181,56,125
879,1502,LIMA,BARRANCA,202009,593,47,96,61,35
880,1502,LIMA,BARRANCA,202010,326,33,71,50,21
881,1502,LIMA,BARRANCA,202011,258,18,74,19,55
882,1502,LIMA,BARRANCA,202012,214,14,53,26,27
865,1502,LIMA,BARRANCA,202101,317,40,97,17,80
866,1502,LIMA,BARRANCA,202102,782,90,137,29,108
868,1502,LIMA,BARRANCA,202103,1382,139,202,15,187
870,1502,LIMA,BARRANCA,202104,1357,197,251,19,232
872,1502,LIMA,BARRANCA,202105,607,114,162,18,144
874,1502,LIMA,BARRANCA,202106,229,39,101,55,46
876,1502,LIMA,BARRANCA,202107,92,13,72,60,12
878,1502,LIMA,BARRANCA,202108,64,7,73,56,17
885,1503,LIMA,CAJATAMBO,202003,0,0,4,1,3
887,1503,LIMA,CAJATAMBO,202004,1,0,0,1,-1
889,1503,LIMA,CAJATAMBO,202005,9,0,1,2,-1
891,1503,LIMA,CAJATAMBO,202006,3,5,3,0,3
893,1503,LIMA,CAJATAMBO,202007,7,12,2,0,2
895,1503,LIMA,CAJATAMBO,202008,7,23,4,1,3
897,1503,LIMA,CAJATAMBO,202009,3,1,2,1,1
898,1503,LIMA,CAJATAMBO,202010,0,0,1,3,-2
899,1503,LIMA,CAJATAMBO,202011,4,1,1,4,-3
900,1503,LIMA,CAJATAMBO,202012,1,1,5,1,4
883,1503,LIMA,CAJATAMBO,202101,3,0,0,3,-3
884,1503,LIMA,CAJATAMBO,202102,36,2,9,3,6
886,1503,LIMA,CAJATAMBO,202103,80,4,6,1,5
888,1503,LIMA,CAJATAMBO,202104,60,0,5,1,4
890,1503,LIMA,CAJATAMBO,202105,51,3,5,2,3
892,1503,LIMA,CAJATAMBO,202106,57,3,3,0,3
894,1503,LIMA,CAJATAMBO,202107,1,1,6,0,6
896,1503,LIMA,CAJATAMBO,202108,3,0,4,1,3
903,1504,LIMA,CANTA,202003,0,0,6,8,-2
905,1504,LIMA,CANTA,202004,11,0,9,5,4
907,1504,LIMA,CANTA,202005,41,5,11,5,6
909,1504,LIMA,CANTA,202006,106,5,7,6,1
911,1504,LIMA,CANTA,202007,106,6,17,6,11
913,1504,LIMA,CANTA,202008,58,13,16,1,15
915,1504,LIMA,CANTA,202009,26,2,7,5,2
916,1504,LIMA,CANTA,202010,14,1,8,3,5
917,1504,LIMA,CANTA,202011,6,0,3,6,-3
918,1504,LIMA,CANTA,202012,9,1,5,4,1
901,1504,LIMA,CANTA,202101,52,6,15,6,9
902,1504,LIMA,CANTA,202102,58,5,15,5,10
904,1504,LIMA,CANTA,202103,89,3,15,8,7
906,1504,LIMA,CANTA,202104,138,10,22,5,17
908,1504,LIMA,CANTA,202105,77,4,12,5,7
910,1504,LIMA,CANTA,202106,37,3,6,6,0
912,1504,LIMA,CANTA,202107,15,1,4,6,-2
914,1504,LIMA,CANTA,202108,21,1,5,1,4
921,1505,LIMA,CAÑETE,202003,1,0,42,86,-44
923,1505,LIMA,CAÑETE,202004,333,47,65,64,1
925,1505,LIMA,CAÑETE,202005,1314,133,147,66,81
927,1505,LIMA,CAÑETE,202006,1773,225,237,81,156
929,1505,LIMA,CAÑETE,202007,1353,188,187,97,90
931,1505,LIMA,CAÑETE,202008,1539,129,133,87,46
933,1505,LIMA,CAÑETE,202009,761,72,73,54,19
934,1505,LIMA,CAÑETE,202010,75,38,63,82,-19
935,1505,LIMA,CAÑETE,202011,85,23,51,71,-20
936,1505,LIMA,CAÑETE,202012,98,21,62,68,-6
919,1505,LIMA,CAÑETE,202101,786,87,119,59,60
920,1505,LIMA,CAÑETE,202102,1023,217,236,79,157
922,1505,LIMA,CAÑETE,202103,372,237,265,86,179
924,1505,LIMA,CAÑETE,202104,268,239,300,64,236
926,1505,LIMA,CAÑETE,202105,352,185,240,66,174
928,1505,LIMA,CAÑETE,202106,58,56,110,81,29
930,1505,LIMA,CAÑETE,202107,13,22,81,97,-16
932,1505,LIMA,CAÑETE,202108,6,7,55,87,-32
939,1506,LIMA,HUARAL,202003,4,0,76,77,-1
941,1506,LIMA,HUARAL,202004,152,19,90,73,17
943,1506,LIMA,HUARAL,202005,1355,114,204,75,129
945,1506,LIMA,HUARAL,202006,1284,199,276,89,187
947,1506,LIMA,HUARAL,202007,895,122,190,83,107
949,1506,LIMA,HUARAL,202008,1949,79,129,71,58
951,1506,LIMA,HUARAL,202009,572,45,97,80,17
952,1506,LIMA,HUARAL,202010,237,32,79,65,14
953,1506,LIMA,HUARAL,202011,127,18,63,76,-13
954,1506,LIMA,HUARAL,202012,200,16,106,56,50
937,1506,LIMA,HUARAL,202101,806,57,123,72,51
938,1506,LIMA,HUARAL,202102,1449,106,178,86,92
940,1506,LIMA,HUARAL,202103,2228,167,240,77,163
942,1506,LIMA,HUARAL,202104,2209,206,276,73,203
944,1506,LIMA,HUARAL,202105,923,140,207,75,132
946,1506,LIMA,HUARAL,202106,282,50,124,89,35
948,1506,LIMA,HUARAL,202107,173,19,91,83,8
950,1506,LIMA,HUARAL,202108,198,15,101,71,30
957,1507,LIMA,HUAROCHIRI,202003,0,0,42,31,11
959,1507,LIMA,HUAROCHIRI,202004,51,6,30,22,8
961,1507,LIMA,HUAROCHIRI,202005,278,21,63,28,35
963,1507,LIMA,HUAROCHIRI,202006,186,33,79,25,54
965,1507,LIMA,HUAROCHIRI,202007,263,32,85,32,53
967,1507,LIMA,HUAROCHIRI,202008,480,53,108,33,75
969,1507,LIMA,HUAROCHIRI,202009,160,23,64,20,44
970,1507,LIMA,HUAROCHIRI,202010,56,7,44,28,16
971,1507,LIMA,HUAROCHIRI,202011,45,6,25,31,-6
972,1507,LIMA,HUAROCHIRI,202012,36,8,43,28,15
955,1507,LIMA,HUAROCHIRI,202101,172,23,88,32,56
956,1507,LIMA,HUAROCHIRI,202102,418,45,93,30,63
958,1507,LIMA,HUAROCHIRI,202103,700,69,133,31,102
960,1507,LIMA,HUAROCHIRI,202104,740,73,122,22,100
962,1507,LIMA,HUAROCHIRI,202105,388,61,107,28,79
964,1507,LIMA,HUAROCHIRI,202106,176,19,57,25,32
966,1507,LIMA,HUAROCHIRI,202107,150,9,51,32,19
968,1507,LIMA,HUAROCHIRI,202108,68,11,42,33,9
975,1508,LIMA,HUAURA,202003,2,1,52,45,7
977,1508,LIMA,HUAURA,202004,208,15,56,53,3
979,1508,LIMA,HUAURA,202005,626,61,95,41,54
981,1508,LIMA,HUAURA,202006,1556,172,197,51,146
983,1508,LIMA,HUAURA,202007,1717,248,308,66,242
985,1508,LIMA,HUAURA,202008,1717,179,244,57,187
987,1508,LIMA,HUAURA,202009,838,89,175,60,115
988,1508,LIMA,HUAURA,202010,450,44,136,57,79
989,1508,LIMA,HUAURA,202011,196,19,88,49,39
990,1508,LIMA,HUAURA,202012,199,27,110,51,59
973,1508,LIMA,HUAURA,202101,882,73,158,43,115
974,1508,LIMA,HUAURA,202102,1653,147,225,56,169
976,1508,LIMA,HUAURA,202103,2531,209,310,45,265
978,1508,LIMA,HUAURA,202104,2738,270,354,53,301
980,1508,LIMA,HUAURA,202105,1173,194,274,41,233
982,1508,LIMA,HUAURA,202106,645,69,146,51,95
984,1508,LIMA,HUAURA,202107,277,22,115,66,49
986,1508,LIMA,HUAURA,202108,186,19,109,57,52
993,1509,LIMA,OYON,202003,0,0,3,5,-2
995,1509,LIMA,OYON,202004,8,2,4,2,2
997,1509,LIMA,OYON,202005,9,2,5,4,1
999,1509,LIMA,OYON,202006,18,2,6,1,5
1001,1509,LIMA,OYON,202007,3,7,10,5,5
1003,1509,LIMA,OYON,202008,35,4,10,1,9
1005,1509,LIMA,OYON,202009,21,3,10,2,8
1006,1509,LIMA,OYON,202010,4,1,11,4,7
1007,1509,LIMA,OYON,202011,4,3,7,2,5
1008,1509,LIMA,OYON,202012,6,2,3,5,-2
991,1509,LIMA,OYON,202101,26,8,13,2,11
992,1509,LIMA,OYON,202102,46,6,11,4,7
994,1509,LIMA,OYON,202103,71,10,18,5,13
996,1509,LIMA,OYON,202104,93,10,18,2,16
998,1509,LIMA,OYON,202105,47,10,14,4,10
1000,1509,LIMA,OYON,202106,35,4,8,1,7
1002,1509,LIMA,OYON,202107,5,1,3,5,-2
1004,1509,LIMA,OYON,202108,23,0,10,1,9
1011,1510,LIMA,YAUYOS,202003,0,0,5,3,2
1013,1510,LIMA,YAUYOS,202004,7,1,4,8,-4
1015,1510,LIMA,YAUYOS,202005,20,4,13,7,6
1017,1510,LIMA,YAUYOS,202006,29,3,18,5,13
1019,1510,LIMA,YAUYOS,202007,60,3,15,4,11
1021,1510,LIMA,YAUYOS,202008,28,8,24,4,20
1023,1510,LIMA,YAUYOS,202009,40,3,12,5,7
1024,1510,LIMA,YAUYOS,202010,40,4,9,9,0
1025,1510,LIMA,YAUYOS,202011,6,0,4,8,-4
1026,1510,LIMA,YAUYOS,202012,6,2,11,6,5
1009,1510,LIMA,YAUYOS,202101,17,8,20,7,13
1010,1510,LIMA,YAUYOS,202102,21,8,16,11,5
1012,1510,LIMA,YAUYOS,202103,86,11,24,3,21
1014,1510,LIMA,YAUYOS,202104,82,11,33,8,25
1016,1510,LIMA,YAUYOS,202105,44,5,24,7,17
1018,1510,LIMA,YAUYOS,202106,11,2,12,5,7
1020,1510,LIMA,YAUYOS,202107,40,3,8,4,4
1022,1510,LIMA,YAUYOS,202108,11,0,19,4,15
1029,1601,LORETO,MAYNAS,202003,62,13,142,103,39
1031,1601,LORETO,MAYNAS,202004,1382,430,435,104,331
1033,1601,LORETO,MAYNAS,202005,3111,1140,883,94,789
1035,1601,LORETO,MAYNAS,202006,2309,161,209,115,94
1037,1601,LORETO,MAYNAS,202007,1252,72,155,119,36
1039,1601,LORETO,MAYNAS,202008,1979,77,193,109,84
1041,1601,LORETO,MAYNAS,202009,1308,27,144,112,32
1042,1601,LORETO,MAYNAS,202010,798,20,161,126,35
1043,1601,LORETO,MAYNAS,202011,631,14,158,111,47
1044,1601,LORETO,MAYNAS,202012,575,12,175,143,32
1027,1601,LORETO,MAYNAS,202101,1048,67,219,110,109
1028,1601,LORETO,MAYNAS,202102,4267,442,578,82,496
1030,1601,LORETO,MAYNAS,202103,1821,250,382,103,279
1032,1601,LORETO,MAYNAS,202104,1104,73,216,104,112
1034,1601,LORETO,MAYNAS,202105,738,50,213,94,119
1036,1601,LORETO,MAYNAS,202106,1301,42,187,115,72
1038,1601,LORETO,MAYNAS,202107,1646,83,226,119,107
1040,1601,LORETO,MAYNAS,202108,218,20,188,109,79
1047,1602,LORETO,ALTO AMAZONAS,202003,0,1,39,32,7
1049,1602,LORETO,ALTO AMAZONAS,202004,23,4,23,26,-3
1051,1602,LORETO,ALTO AMAZONAS,202005,712,59,99,30,69
1053,1602,LORETO,ALTO AMAZONAS,202006,349,105,128,42,86
1055,1602,LORETO,ALTO AMAZONAS,202007,509,46,57,30,27
1057,1602,LORETO,ALTO AMAZONAS,202008,339,17,38,43,-5
1059,1602,LORETO,ALTO AMAZONAS,202009,216,1,33,32,1
1060,1602,LORETO,ALTO AMAZONAS,202010,150,9,42,21,21
1061,1602,LORETO,ALTO AMAZONAS,202011,111,5,25,30,-5
1062,1602,LORETO,ALTO AMAZONAS,202012,37,7,44,49,-5
1045,1602,LORETO,ALTO AMAZONAS,202101,94,7,47,48,-1
1046,1602,LORETO,ALTO AMAZONAS,202102,265,15,42,26,16
1048,1602,LORETO,ALTO AMAZONAS,202103,1217,53,80,32,48
1050,1602,LORETO,ALTO AMAZONAS,202104,676,40,72,26,46
1052,1602,LORETO,ALTO AMAZONAS,202105,187,11,49,30,19
1054,1602,LORETO,ALTO AMAZONAS,202106,52,12,47,42,5
1056,1602,LORETO,ALTO AMAZONAS,202107,48,4,43,30,13
1058,1602,LORETO,ALTO AMAZONAS,202108,40,3,42,43,-1
1065,1603,LORETO,LORETO,202003,0,0,5,10,-5
1067,1603,LORETO,LORETO,202004,34,3,5,9,-4
1069,1603,LORETO,LORETO,202005,232,54,68,8,60
1071,1603,LORETO,LORETO,202006,315,24,33,7,26
1073,1603,LORETO,LORETO,202007,705,14,19,3,16
1075,1603,LORETO,LORETO,202008,1008,12,14,2,12
1077,1603,LORETO,LORETO,202009,503,4,15,6,9
1078,1603,LORETO,LORETO,202010,176,4,16,5,11
1079,1603,LORETO,LORETO,202011,169,2,11,4,7
1080,1603,LORETO,LORETO,202012,176,1,12,3,9
1063,1603,LORETO,LORETO,202101,76,1,12,10,2
1064,1603,LORETO,LORETO,202102,266,8,19,6,13
1066,1603,LORETO,LORETO,202103,196,16,18,10,8
1068,1603,LORETO,LORETO,202104,117,1,9,9,0
1070,1603,LORETO,LORETO,202105,42,2,16,8,8
1072,1603,LORETO,LORETO,202106,86,2,16,7,9
1074,1603,LORETO,LORETO,202107,63,1,15,3,12
1076,1603,LORETO,LORETO,202108,26,1,7,2,5
1083,1604,LORETO,MARISCAL RAMON CASTILLA,202003,0,1,3,7,-4
1085,1604,LORETO,MARISCAL RAMON CASTILLA,202004,32,3,8,6,2
1087,1604,LORETO,MARISCAL RAMON CASTILLA,202005,161,40,14,10,4
1089,1604,LORETO,MARISCAL RAMON CASTILLA,202006,112,22,19,6,13
1091,1604,LORETO,MARISCAL RAMON CASTILLA,202007,119,13,16,14,2
1093,1604,LORETO,MARISCAL RAMON CASTILLA,202008,346,2,9,10,-1
1095,1604,LORETO,MARISCAL RAMON CASTILLA,202009,284,3,7,11,-4
1096,1604,LORETO,MARISCAL RAMON CASTILLA,202010,186,1,4,8,-4
1097,1604,LORETO,MARISCAL RAMON CASTILLA,202011,121,1,12,3,9
1098,1604,LORETO,MARISCAL RAMON CASTILLA,202012,10,0,5,7,-2
1081,1604,LORETO,MARISCAL RAMON CASTILLA,202101,92,18,21,5,16
1082,1604,LORETO,MARISCAL RAMON CASTILLA,202102,338,23,22,3,19
1084,1604,LORETO,MARISCAL RAMON CASTILLA,202103,165,15,16,7,9
1086,1604,LORETO,MARISCAL RAMON CASTILLA,202104,36,3,11,6,5
1088,1604,LORETO,MARISCAL RAMON CASTILLA,202105,41,0,5,10,-5
1090,1604,LORETO,MARISCAL RAMON CASTILLA,202106,51,0,4,6,-2
1092,1604,LORETO,MARISCAL RAMON CASTILLA,202107,208,5,10,14,-4
1094,1604,LORETO,MARISCAL RAMON CASTILLA,202108,54,0,3,10,-7
1101,1605,LORETO,REQUENA,202003,0,2,16,10,6
1103,1605,LORETO,REQUENA,202004,5,6,14,16,-2
1105,1605,LORETO,REQUENA,202005,43,81,83,13,70
1107,1605,LORETO,REQUENA,202006,195,34,35,14,21
1109,1605,LORETO,REQUENA,202007,71,10,18,19,-1
1111,1605,LORETO,REQUENA,202008,246,10,16,13,3
1113,1605,LORETO,REQUENA,202009,389,3,10,12,-2
1114,1605,LORETO,REQUENA,202010,360,4,17,15,2
1115,1605,LORETO,REQUENA,202011,188,0,16,15,1
1116,1605,LORETO,REQUENA,202012,42,2,15,10,5
1099,1605,LORETO,REQUENA,202101,32,1,17,9,8
1100,1605,LORETO,REQUENA,202102,92,7,16,9,7
1102,1605,LORETO,REQUENA,202103,156,15,32,10,22
1104,1605,LORETO,REQUENA,202104,55,9,20,16,4
1106,1605,LORETO,REQUENA,202105,173,5,19,13,6
1108,1605,LORETO,REQUENA,202106,91,0,14,14,0
1110,1605,LORETO,REQUENA,202107,121,2,13,19,-6
1112,1605,LORETO,REQUENA,202108,39,2,13,13,0
1119,1606,LORETO,UCAYALI,202003,0,0,3,12,-9
1121,1606,LORETO,UCAYALI,202004,3,1,11,12,-1
1123,1606,LORETO,UCAYALI,202005,159,31,34,10,24
1125,1606,LORETO,UCAYALI,202006,178,25,27,6,21
1127,1606,LORETO,UCAYALI,202007,101,8,18,12,6
1129,1606,LORETO,UCAYALI,202008,65,8,25,10,15
1131,1606,LORETO,UCAYALI,202009,175,3,18,6,12
1132,1606,LORETO,UCAYALI,202010,29,2,18,5,13
1133,1606,LORETO,UCAYALI,202011,49,3,20,10,10
1134,1606,LORETO,UCAYALI,202012,11,1,20,15,5
1117,1606,LORETO,UCAYALI,202101,30,8,23,9,14
1118,1606,LORETO,UCAYALI,202102,74,5,23,13,10
1120,1606,LORETO,UCAYALI,202103,78,22,44,12,32
1122,1606,LORETO,UCAYALI,202104,60,14,36,12,24
1124,1606,LORETO,UCAYALI,202105,35,8,29,10,19
1126,1606,LORETO,UCAYALI,202106,16,4,21,6,15
1128,1606,LORETO,UCAYALI,202107,6,3,22,12,10
1130,1606,LORETO,UCAYALI,202108,0,1,16,10,6
1137,1607,LORETO,DATEM DEL MARAÑON,202003,0,0,9,2,7
1139,1607,LORETO,DATEM DEL MARAÑON,202004,7,3,8,3,5
1141,1607,LORETO,DATEM DEL MARAÑON,202005,152,3,7,4,3
1143,1607,LORETO,DATEM DEL MARAÑON,202006,404,22,23,2,21
1145,1607,LORETO,DATEM DEL MARAÑON,202007,796,19,16,2,14
1147,1607,LORETO,DATEM DEL MARAÑON,202008,564,10,11,4,7
1149,1607,LORETO,DATEM DEL MARAÑON,202009,200,3,7,3,4
1150,1607,LORETO,DATEM DEL MARAÑON,202010,173,3,7,1,6
1151,1607,LORETO,DATEM DEL MARAÑON,202011,51,5,11,2,9
1152,1607,LORETO,DATEM DEL MARAÑON,202012,26,2,8,2,6
1135,1607,LORETO,DATEM DEL MARAÑON,202101,15,0,10,3,7
1136,1607,LORETO,DATEM DEL MARAÑON,202102,55,12,15,2,13
1138,1607,LORETO,DATEM DEL MARAÑON,202103,173,5,11,2,9
1140,1607,LORETO,DATEM DEL MARAÑON,202104,70,5,7,3,4
1142,1607,LORETO,DATEM DEL MARAÑON,202105,108,8,11,4,7
1144,1607,LORETO,DATEM DEL MARAÑON,202106,60,2,8,2,6
1146,1607,LORETO,DATEM DEL MARAÑON,202107,36,3,15,2,13
1148,1607,LORETO,DATEM DEL MARAÑON,202108,4,1,9,4,5
1155,1608,LORETO,PUTUMAYO,202003,0,0,0,0,0
1157,1608,LORETO,PUTUMAYO,202004,1,0,0,0,0
1159,1608,LORETO,PUTUMAYO,202005,8,0,0,0,0
1161,1608,LORETO,PUTUMAYO,202006,155,8,2,1,1
1163,1608,LORETO,PUTUMAYO,202007,288,6,5,1,4
1165,1608,LORETO,PUTUMAYO,202008,381,0,0,0,0
1167,1608,LORETO,PUTUMAYO,202009,53,0,0,2,-2
1168,1608,LORETO,PUTUMAYO,202010,17,0,0,1,-1
1169,1608,LORETO,PUTUMAYO,202011,162,0,0,0,0
1170,1608,LORETO,PUTUMAYO,202012,140,0,1,0,1
1153,1608,LORETO,PUTUMAYO,202101,16,0,1,1,0
1154,1608,LORETO,PUTUMAYO,202102,29,0,0,1,-1
1156,1608,LORETO,PUTUMAYO,202103,25,3,4,0,4
1158,1608,LORETO,PUTUMAYO,202104,14,2,2,0,2
1160,1608,LORETO,PUTUMAYO,202105,11,0,0,0,0
1162,1608,LORETO,PUTUMAYO,202106,7,0,1,1,0
1164,1608,LORETO,PUTUMAYO,202107,4,0,0,1,-1
1166,1608,LORETO,PUTUMAYO,202108,0,0,1,0,1
1173,1701,MADRE DE DIOS,TAMBOPATA,202003,1,1,54,52,2
1175,1701,MADRE DE DIOS,TAMBOPATA,202004,122,1,37,57,-20
1177,1701,MADRE DE DIOS,TAMBOPATA,202005,419,10,63,49,14
1179,1701,MADRE DE DIOS,TAMBOPATA,202006,1406,131,180,47,133
1181,1701,MADRE DE DIOS,TAMBOPATA,202007,1536,142,175,52,123
1183,1701,MADRE DE DIOS,TAMBOPATA,202008,2013,65,104,44,60
1185,1701,MADRE DE DIOS,TAMBOPATA,202009,1623,21,62,61,1
1186,1701,MADRE DE DIOS,TAMBOPATA,202010,374,14,65,64,1
1187,1701,MADRE DE DIOS,TAMBOPATA,202011,264,8,53,55,-2
1188,1701,MADRE DE DIOS,TAMBOPATA,202012,173,12,46,61,-15
1171,1701,MADRE DE DIOS,TAMBOPATA,202101,120,27,72,40,32
1172,1701,MADRE DE DIOS,TAMBOPATA,202102,377,21,61,49,12
1174,1701,MADRE DE DIOS,TAMBOPATA,202103,1251,77,137,52,85
1176,1701,MADRE DE DIOS,TAMBOPATA,202104,728,88,128,57,71
1178,1701,MADRE DE DIOS,TAMBOPATA,202105,396,28,80,49,31
1180,1701,MADRE DE DIOS,TAMBOPATA,202106,158,11,66,47,19
1182,1701,MADRE DE DIOS,TAMBOPATA,202107,81,11,56,52,4
1184,1701,MADRE DE DIOS,TAMBOPATA,202108,72,7,75,44,31
1191,1702,MADRE DE DIOS,MANU,202003,0,0,4,5,-1
1193,1702,MADRE DE DIOS,MANU,202004,0,0,4,1,3
1195,1702,MADRE DE DIOS,MANU,202005,1,0,4,2,2
1197,1702,MADRE DE DIOS,MANU,202006,33,5,9,8,1
1199,1702,MADRE DE DIOS,MANU,202007,62,1,7,7,0
1201,1702,MADRE DE DIOS,MANU,202008,390,8,9,4,5
1203,1702,MADRE DE DIOS,MANU,202009,43,3,13,5,8
1204,1702,MADRE DE DIOS,MANU,202010,32,0,2,5,-3
1205,1702,MADRE DE DIOS,MANU,202011,37,1,3,4,-1
1206,1702,MADRE DE DIOS,MANU,202012,21,0,2,2,0
1189,1702,MADRE DE DIOS,MANU,202101,31,3,7,5,2
1190,1702,MADRE DE DIOS,MANU,202102,45,3,7,5,2
1192,1702,MADRE DE DIOS,MANU,202103,109,10,15,5,10
1194,1702,MADRE DE DIOS,MANU,202104,88,6,12,1,11
1196,1702,MADRE DE DIOS,MANU,202105,30,2,3,2,1
1198,1702,MADRE DE DIOS,MANU,202106,22,1,6,8,-2
1200,1702,MADRE DE DIOS,MANU,202107,3,0,11,7,4
1202,1702,MADRE DE DIOS,MANU,202108,5,0,8,4,4
1209,1703,MADRE DE DIOS,TAHUAMANU,202003,0,0,1,4,-3
1211,1703,MADRE DE DIOS,TAHUAMANU,202004,6,0,2,3,-1
1213,1703,MADRE DE DIOS,TAHUAMANU,202005,43,0,2,4,-2
1215,1703,MADRE DE DIOS,TAHUAMANU,202006,60,3,5,1,4
1217,1703,MADRE DE DIOS,TAHUAMANU,202007,247,11,11,2,9
1219,1703,MADRE DE DIOS,TAHUAMANU,202008,292,12,8,1,7
1221,1703,MADRE DE DIOS,TAHUAMANU,202009,189,2,3,4,-1
1222,1703,MADRE DE DIOS,TAHUAMANU,202010,73,1,6,3,3
1223,1703,MADRE DE DIOS,TAHUAMANU,202011,61,0,2,3,-1
1224,1703,MADRE DE DIOS,TAHUAMANU,202012,66,0,2,3,-1
1207,1703,MADRE DE DIOS,TAHUAMANU,202101,22,2,4,0,4
1208,1703,MADRE DE DIOS,TAHUAMANU,202102,61,1,5,3,2
1210,1703,MADRE DE DIOS,TAHUAMANU,202103,200,3,3,4,-1
1212,1703,MADRE DE DIOS,TAHUAMANU,202104,105,6,7,3,4
1214,1703,MADRE DE DIOS,TAHUAMANU,202105,126,1,3,4,-1
1216,1703,MADRE DE DIOS,TAHUAMANU,202106,48,1,9,1,8
1218,1703,MADRE DE DIOS,TAHUAMANU,202107,54,0,4,2,2
1220,1703,MADRE DE DIOS,TAHUAMANU,202108,28,0,1,1,0
1227,1801,MOQUEGUA,MARISCAL NIETO,202003,0,0,35,33,2
1229,1801,MOQUEGUA,MARISCAL NIETO,202004,63,1,20,34,-14
1231,1801,MOQUEGUA,MARISCAL NIETO,202005,296,2,25,49,-24
1233,1801,MOQUEGUA,MARISCAL NIETO,202006,171,5,35,39,-4
1235,1801,MOQUEGUA,MARISCAL NIETO,202007,1227,136,163,37,126
1237,1801,MOQUEGUA,MARISCAL NIETO,202008,4387,285,313,48,265
1239,1801,MOQUEGUA,MARISCAL NIETO,202009,3082,41,63,43,20
1240,1801,MOQUEGUA,MARISCAL NIETO,202010,666,20,36,27,9
1241,1801,MOQUEGUA,MARISCAL NIETO,202011,463,8,36,42,-6
1242,1801,MOQUEGUA,MARISCAL NIETO,202012,393,12,28,30,-2
1225,1801,MOQUEGUA,MARISCAL NIETO,202101,809,31,46,33,13
1226,1801,MOQUEGUA,MARISCAL NIETO,202102,1167,28,53,32,21
1228,1801,MOQUEGUA,MARISCAL NIETO,202103,1270,17,41,33,8
1230,1801,MOQUEGUA,MARISCAL NIETO,202104,772,21,49,34,15
1232,1801,MOQUEGUA,MARISCAL NIETO,202105,636,34,57,49,8
1234,1801,MOQUEGUA,MARISCAL NIETO,202106,1192,28,66,39,27
1236,1801,MOQUEGUA,MARISCAL NIETO,202107,1157,39,67,37,30
1238,1801,MOQUEGUA,MARISCAL NIETO,202108,586,22,49,48,1
1245,1802,MOQUEGUA,GENERAL SANCHEZ CERRO,202003,0,0,1,4,-3
1247,1802,MOQUEGUA,GENERAL SANCHEZ CERRO,202004,2,1,9,4,5
1249,1802,MOQUEGUA,GENERAL SANCHEZ CERRO,202005,5,0,6,4,2
1251,1802,MOQUEGUA,GENERAL SANCHEZ CERRO,202006,38,2,13,7,6
1253,1802,MOQUEGUA,GENERAL SANCHEZ CERRO,202007,96,3,14,9,5
1255,1802,MOQUEGUA,GENERAL SANCHEZ CERRO,202008,191,11,14,7,7
1257,1802,MOQUEGUA,GENERAL SANCHEZ CERRO,202009,82,0,10,11,-1
1258,1802,MOQUEGUA,GENERAL SANCHEZ CERRO,202010,19,0,5,4,1
1259,1802,MOQUEGUA,GENERAL SANCHEZ CERRO,202011,14,0,6,9,-3
1260,1802,MOQUEGUA,GENERAL SANCHEZ CERRO,202012,8,0,6,5,1
1243,1802,MOQUEGUA,GENERAL SANCHEZ CERRO,202101,44,5,19,4,15
1244,1802,MOQUEGUA,GENERAL SANCHEZ CERRO,202102,97,4,8,7,1
1246,1802,MOQUEGUA,GENERAL SANCHEZ CERRO,202103,79,2,10,4,6
1248,1802,MOQUEGUA,GENERAL SANCHEZ CERRO,202104,90,9,14,4,10
1250,1802,MOQUEGUA,GENERAL SANCHEZ CERRO,202105,164,8,17,4,13
1252,1802,MOQUEGUA,GENERAL SANCHEZ CERRO,202106,190,5,16,7,9
1254,1802,MOQUEGUA,GENERAL SANCHEZ CERRO,202107,68,2,5,9,-4
1256,1802,MOQUEGUA,GENERAL SANCHEZ CERRO,202108,26,0,12,7,5
1263,1803,MOQUEGUA,ILO,202003,0,0,24,20,4
1265,1803,MOQUEGUA,ILO,202004,85,0,17,28,-11
1267,1803,MOQUEGUA,ILO,202005,230,7,30,28,2
1269,1803,MOQUEGUA,ILO,202006,118,17,44,27,17
1271,1803,MOQUEGUA,ILO,202007,844,123,151,33,118
1273,1803,MOQUEGUA,ILO,202008,1377,111,122,32,90
1275,1803,MOQUEGUA,ILO,202009,838,29,42,29,13
1276,1803,MOQUEGUA,ILO,202010,362,22,42,33,9
1277,1803,MOQUEGUA,ILO,202011,403,15,29,33,-4
1278,1803,MOQUEGUA,ILO,202012,362,33,52,24,28
1261,1803,MOQUEGUA,ILO,202101,957,116,137,28,109
1262,1803,MOQUEGUA,ILO,202102,814,38,61,30,31
1264,1803,MOQUEGUA,ILO,202103,409,23,43,20,23
1266,1803,MOQUEGUA,ILO,202104,507,30,53,28,25
1268,1803,MOQUEGUA,ILO,202105,641,77,95,28,67
1270,1803,MOQUEGUA,ILO,202106,510,46,72,27,45
1272,1803,MOQUEGUA,ILO,202107,460,20,39,33,6
1274,1803,MOQUEGUA,ILO,202108,281,6,34,32,2
1281,1901,PASCO,PASCO,202003,1,0,37,17,20
1283,1901,PASCO,PASCO,202004,106,4,36,19,17
1285,1901,PASCO,PASCO,202005,245,11,62,20,42
1287,1901,PASCO,PASCO,202006,330,17,54,11,43
1289,1901,PASCO,PASCO,202007,653,48,92,17,75
1291,1901,PASCO,PASCO,202008,1394,73,107,32,75
1293,1901,PASCO,PASCO,202009,726,33,60,25,35
1294,1901,PASCO,PASCO,202010,319,13,43,35,8
1295,1901,PASCO,PASCO,202011,182,9,39,35,4
1296,1901,PASCO,PASCO,202012,228,25,53,52,1
1279,1901,PASCO,PASCO,202101,961,104,137,16,121
1280,1901,PASCO,PASCO,202102,497,59,93,10,83
1282,1901,PASCO,PASCO,202103,358,37,75,17,58
1284,1901,PASCO,PASCO,202104,433,47,74,19,55
1286,1901,PASCO,PASCO,202105,337,56,86,20,66
1288,1901,PASCO,PASCO,202106,218,37,58,11,47
1290,1901,PASCO,PASCO,202107,116,17,48,17,31
1292,1901,PASCO,PASCO,202108,49,5,32,32,0
1299,1902,PASCO,DANIEL ALCIDES CARRION,202003,0,0,16,7,9
1301,1902,PASCO,DANIEL ALCIDES CARRION,202004,13,0,12,8,4
1303,1902,PASCO,DANIEL ALCIDES CARRION,202005,7,4,14,5,9
1305,1902,PASCO,DANIEL ALCIDES CARRION,202006,16,5,17,8,9
1307,1902,PASCO,DANIEL ALCIDES CARRION,202007,78,8,19,5,14
1309,1902,PASCO,DANIEL ALCIDES CARRION,202008,189,11,23,7,16
1311,1902,PASCO,DANIEL ALCIDES CARRION,202009,95,5,11,7,4
1312,1902,PASCO,DANIEL ALCIDES CARRION,202010,105,0,10,14,-4
1313,1902,PASCO,DANIEL ALCIDES CARRION,202011,13,2,10,8,2
1314,1902,PASCO,DANIEL ALCIDES CARRION,202012,20,2,12,10,2
1297,1902,PASCO,DANIEL ALCIDES CARRION,202101,144,13,32,9,23
1298,1902,PASCO,DANIEL ALCIDES CARRION,202102,61,10,30,2,28
1300,1902,PASCO,DANIEL ALCIDES CARRION,202103,54,2,13,7,6
1302,1902,PASCO,DANIEL ALCIDES CARRION,202104,111,11,24,8,16
1304,1902,PASCO,DANIEL ALCIDES CARRION,202105,86,13,21,5,16
1306,1902,PASCO,DANIEL ALCIDES CARRION,202106,30,8,18,8,10
1308,1902,PASCO,DANIEL ALCIDES CARRION,202107,14,5,12,5,7
1310,1902,PASCO,DANIEL ALCIDES CARRION,202108,7,0,10,7,3
1317,1903,PASCO,OXAPAMPA,202003,0,0,30,27,3
1319,1903,PASCO,OXAPAMPA,202004,35,0,15,22,-7
1321,1903,PASCO,OXAPAMPA,202005,151,3,28,24,4
1323,1903,PASCO,OXAPAMPA,202006,160,4,17,17,0
1325,1903,PASCO,OXAPAMPA,202007,155,10,39,33,6
1327,1903,PASCO,OXAPAMPA,202008,351,12,42,27,15
1329,1903,PASCO,OXAPAMPA,202009,222,19,37,24,13
1330,1903,PASCO,OXAPAMPA,202010,202,2,33,20,13
1331,1903,PASCO,OXAPAMPA,202011,242,11,36,19,17
1332,1903,PASCO,OXAPAMPA,202012,132,8,34,19,15
1315,1903,PASCO,OXAPAMPA,202101,335,16,47,18,29
1316,1903,PASCO,OXAPAMPA,202102,985,37,74,24,50
1318,1903,PASCO,OXAPAMPA,202103,1093,50,93,27,66
1320,1903,PASCO,OXAPAMPA,202104,1336,61,83,22,61
1322,1903,PASCO,OXAPAMPA,202105,785,71,106,24,82
1324,1903,PASCO,OXAPAMPA,202106,294,20,51,17,34
1326,1903,PASCO,OXAPAMPA,202107,236,9,37,33,4
1328,1903,PASCO,OXAPAMPA,202108,276,8,38,27,11
1335,2001,PIURA,PIURA,202003,22,3,116,243,-127
1337,2001,PIURA,PIURA,202004,1291,276,363,167,196
1339,2001,PIURA,PIURA,202005,3673,853,978,118,860
1341,2001,PIURA,PIURA,202006,3645,512,673,134,539
1343,2001,PIURA,PIURA,202007,2267,265,406,195,211
1345,2001,PIURA,PIURA,202008,3478,263,399,155,244
1347,2001,PIURA,PIURA,202009,2888,191,341,93,248
1348,2001,PIURA,PIURA,202010,928,128,268,103,165
1349,2001,PIURA,PIURA,202011,1239,168,307,176,131
1350,2001,PIURA,PIURA,202012,1077,224,408,205,203
1333,2001,PIURA,PIURA,202101,1548,313,512,223,289
1334,2001,PIURA,PIURA,202102,1824,227,415,224,191
1336,2001,PIURA,PIURA,202103,4737,406,627,243,384
1338,2001,PIURA,PIURA,202104,6329,805,1059,167,892
1340,2001,PIURA,PIURA,202105,2991,496,702,118,584
1342,2001,PIURA,PIURA,202106,2216,172,391,134,257
1344,2001,PIURA,PIURA,202107,681,65,307,195,112
1346,2001,PIURA,PIURA,202108,592,45,243,155,88
1353,2002,PIURA,AYABACA,202003,0,0,19,39,-20
1355,2002,PIURA,AYABACA,202004,15,3,19,45,-26
1357,2002,PIURA,AYABACA,202005,75,8,35,32,3
1359,2002,PIURA,AYABACA,202006,177,20,45,26,19
1361,2002,PIURA,AYABACA,202007,152,14,37,42,-5
1363,2002,PIURA,AYABACA,202008,250,16,49,34,15
1365,2002,PIURA,AYABACA,202009,207,13,35,31,4
1366,2002,PIURA,AYABACA,202010,85,6,28,43,-15
1367,2002,PIURA,AYABACA,202011,59,8,25,39,-14
1368,2002,PIURA,AYABACA,202012,30,12,40,23,17
1351,2002,PIURA,AYABACA,202101,158,10,43,32,11
1352,2002,PIURA,AYABACA,202102,154,13,45,37,8
1354,2002,PIURA,AYABACA,202103,442,17,60,39,21
1356,2002,PIURA,AYABACA,202104,621,53,81,45,36
1358,2002,PIURA,AYABACA,202105,316,54,96,32,64
1360,2002,PIURA,AYABACA,202106,202,16,43,26,17
1362,2002,PIURA,AYABACA,202107,167,8,31,42,-11
1364,2002,PIURA,AYABACA,202108,50,5,26,34,-8
1371,2003,PIURA,HUANCABAMBA,202003,0,0,24,35,-11
1373,2003,PIURA,HUANCABAMBA,202004,4,0,31,39,-8
1375,2003,PIURA,HUANCABAMBA,202005,25,7,29,22,7
1377,2003,PIURA,HUANCABAMBA,202006,88,7,47,33,14
1379,2003,PIURA,HUANCABAMBA,202007,83,19,58,40,18
1381,2003,PIURA,HUANCABAMBA,202008,166,24,50,22,28
1383,2003,PIURA,HUANCABAMBA,202009,80,16,40,25,15
1384,2003,PIURA,HUANCABAMBA,202010,24,9,39,27,12
1385,2003,PIURA,HUANCABAMBA,202011,14,10,35,37,-2
1386,2003,PIURA,HUANCABAMBA,202012,10,19,48,48,0
1369,2003,PIURA,HUANCABAMBA,202101,31,14,38,28,10
1370,2003,PIURA,HUANCABAMBA,202102,22,4,28,33,-5
1372,2003,PIURA,HUANCABAMBA,202103,96,13,41,35,6
1374,2003,PIURA,HUANCABAMBA,202104,253,20,49,39,10
1376,2003,PIURA,HUANCABAMBA,202105,186,15,41,22,19
1378,2003,PIURA,HUANCABAMBA,202106,65,13,48,33,15
1380,2003,PIURA,HUANCABAMBA,202107,85,6,56,40,16
1382,2003,PIURA,HUANCABAMBA,202108,22,5,28,22,6
1389,2004,PIURA,MORROPON,202003,0,0,49,96,-47
1391,2004,PIURA,MORROPON,202004,68,29,80,73,7
1393,2004,PIURA,MORROPON,202005,251,149,241,90,151
1395,2004,PIURA,MORROPON,202006,277,135,157,69,88
1397,2004,PIURA,MORROPON,202007,389,68,124,75,49
1399,2004,PIURA,MORROPON,202008,326,78,117,60,57
1401,2004,PIURA,MORROPON,202009,253,52,96,61,35
1402,2004,PIURA,MORROPON,202010,62,32,83,76,7
1403,2004,PIURA,MORROPON,202011,59,70,131,68,63
1404,2004,PIURA,MORROPON,202012,99,68,134,92,42
1387,2004,PIURA,MORROPON,202101,121,54,133,77,56
1388,2004,PIURA,MORROPON,202102,137,40,120,71,49
1390,2004,PIURA,MORROPON,202103,259,60,151,96,55
1392,2004,PIURA,MORROPON,202104,592,140,237,73,164
1394,2004,PIURA,MORROPON,202105,510,102,188,90,98
1396,2004,PIURA,MORROPON,202106,340,36,111,69,42
1398,2004,PIURA,MORROPON,202107,134,10,70,75,-5
1400,2004,PIURA,MORROPON,202108,70,11,78,60,18
1407,2005,PIURA,PAITA,202003,1,0,25,34,-9
1409,2005,PIURA,PAITA,202004,119,12,40,26,14
1411,2005,PIURA,PAITA,202005,474,153,168,21,147
1413,2005,PIURA,PAITA,202006,559,137,140,21,119
1415,2005,PIURA,PAITA,202007,366,82,96,20,76
1417,2005,PIURA,PAITA,202008,986,96,130,24,106
1419,2005,PIURA,PAITA,202009,1141,28,66,20,46
1420,2005,PIURA,PAITA,202010,224,20,52,25,27
1421,2005,PIURA,PAITA,202011,119,5,40,28,12
1422,2005,PIURA,PAITA,202012,239,16,49,22,27
1405,2005,PIURA,PAITA,202101,302,35,67,33,34
1406,2005,PIURA,PAITA,202102,479,42,86,31,55
1408,2005,PIURA,PAITA,202103,1147,116,155,34,121
1410,2005,PIURA,PAITA,202104,896,116,145,26,119
1412,2005,PIURA,PAITA,202105,431,42,82,21,61
1414,2005,PIURA,PAITA,202106,136,27,73,21,52
1416,2005,PIURA,PAITA,202107,85,10,43,20,23
1418,2005,PIURA,PAITA,202108,37,5,35,24,11
1425,2006,PIURA,SULLANA,202003,1,2,101,170,-69
1427,2006,PIURA,SULLANA,202004,294,44,126,118,8
1429,2006,PIURA,SULLANA,202005,2070,511,743,93,650
1431,2006,PIURA,SULLANA,202006,2418,276,397,108,289
1433,2006,PIURA,SULLANA,202007,929,117,246,72,174
1435,2006,PIURA,SULLANA,202008,1542,109,215,108,107
1437,2006,PIURA,SULLANA,202009,918,86,193,80,113
1438,2006,PIURA,SULLANA,202010,643,34,135,77,58
1439,2006,PIURA,SULLANA,202011,394,33,158,111,47
1440,2006,PIURA,SULLANA,202012,253,53,184,82,102
1423,2006,PIURA,SULLANA,202101,775,113,265,128,137
1424,2006,PIURA,SULLANA,202102,858,115,258,134,124
1426,2006,PIURA,SULLANA,202103,1528,120,272,170,102
1428,2006,PIURA,SULLANA,202104,2363,289,463,118,345
1430,2006,PIURA,SULLANA,202105,1220,194,344,93,251
1432,2006,PIURA,SULLANA,202106,448,93,223,108,115
1434,2006,PIURA,SULLANA,202107,248,30,149,72,77
1436,2006,PIURA,SULLANA,202108,179,21,145,108,37
1443,2007,PIURA,TALARA,202003,0,0,25,67,-42
1445,2007,PIURA,TALARA,202004,81,12,24,41,-17
1447,2007,PIURA,TALARA,202005,543,148,115,50,65
1449,2007,PIURA,TALARA,202006,1100,123,98,55,43
1451,2007,PIURA,TALARA,202007,293,57,65,55,10
1453,2007,PIURA,TALARA,202008,695,46,65,48,17
1455,2007,PIURA,TALARA,202009,526,49,75,37,38
1456,2007,PIURA,TALARA,202010,245,19,63,35,28
1457,2007,PIURA,TALARA,202011,135,27,53,19,34
1458,2007,PIURA,TALARA,202012,158,39,64,37,27
1441,2007,PIURA,TALARA,202101,223,66,96,47,49
1442,2007,PIURA,TALARA,202102,194,65,88,67,21
1444,2007,PIURA,TALARA,202103,325,104,127,67,60
1446,2007,PIURA,TALARA,202104,440,231,199,41,158
1448,2007,PIURA,TALARA,202105,263,168,182,50,132
1450,2007,PIURA,TALARA,202106,132,51,74,55,19
1452,2007,PIURA,TALARA,202107,75,25,50,55,-5
1454,2007,PIURA,TALARA,202108,118,14,52,48,4
1461,2008,PIURA,SECHURA,202003,1,0,7,3,4
1463,2008,PIURA,SECHURA,202004,40,4,6,8,-2
1465,2008,PIURA,SECHURA,202005,131,34,49,11,38
1467,2008,PIURA,SECHURA,202006,170,41,52,14,38
1469,2008,PIURA,SECHURA,202007,113,24,34,11,23
1471,2008,PIURA,SECHURA,202008,142,42,55,8,47
1473,2008,PIURA,SECHURA,202009,150,7,24,8,16
1474,2008,PIURA,SECHURA,202010,88,12,34,15,19
1475,2008,PIURA,SECHURA,202011,110,15,40,9,31
1476,2008,PIURA,SECHURA,202012,126,36,64,6,58
1459,2008,PIURA,SECHURA,202101,85,21,44,5,39
1460,2008,PIURA,SECHURA,202102,90,12,26,8,18
1462,2008,PIURA,SECHURA,202103,380,32,60,3,57
1464,2008,PIURA,SECHURA,202104,365,60,99,8,91
1466,2008,PIURA,SECHURA,202105,193,41,74,11,63
1468,2008,PIURA,SECHURA,202106,95,13,41,14,27
1470,2008,PIURA,SECHURA,202107,53,8,38,11,27
1472,2008,PIURA,SECHURA,202108,68,3,25,8,17
1659,2101,PUNO,PUNO,202003,0,0,69,101,-32
1661,2101,PUNO,PUNO,202004,119,1,65,77,-12
1663,2101,PUNO,PUNO,202005,88,3,75,79,-4
1665,2101,PUNO,PUNO,202006,91,5,62,91,-29
1667,2101,PUNO,PUNO,202007,602,60,140,86,54
1669,2101,PUNO,PUNO,202008,2093,326,433,88,345
1671,2101,PUNO,PUNO,202009,2204,54,115,94,21
1672,2101,PUNO,PUNO,202010,522,31,90,88,2
1673,2101,PUNO,PUNO,202011,211,10,72,84,-12
1674,2101,PUNO,PUNO,202012,195,17,90,88,2
1657,2101,PUNO,PUNO,202101,684,73,183,87,96
1658,2101,PUNO,PUNO,202102,1178,150,281,86,195
1660,2101,PUNO,PUNO,202103,783,90,223,101,122
1662,2101,PUNO,PUNO,202104,1168,118,213,77,136
1664,2101,PUNO,PUNO,202105,1190,182,283,79,204
1666,2101,PUNO,PUNO,202106,836,99,214,91,123
1668,2101,PUNO,PUNO,202107,582,50,144,86,58
1670,2101,PUNO,PUNO,202108,635,34,117,88,29
1677,2102,PUNO,AZANGARO,202003,0,0,62,46,16
1679,2102,PUNO,AZANGARO,202004,6,1,42,44,-2
1681,2102,PUNO,AZANGARO,202005,7,1,47,55,-8
1683,2102,PUNO,AZANGARO,202006,19,1,48,69,-21
1685,2102,PUNO,AZANGARO,202007,49,10,58,50,8
1687,2102,PUNO,AZANGARO,202008,361,26,79,60,19
1689,2102,PUNO,AZANGARO,202009,272,7,49,54,-5
1690,2102,PUNO,AZANGARO,202010,99,5,49,44,5
1691,2102,PUNO,AZANGARO,202011,71,4,35,51,-16
1692,2102,PUNO,AZANGARO,202012,45,9,54,55,-1
1675,2102,PUNO,AZANGARO,202101,87,16,108,50,58
1676,2102,PUNO,AZANGARO,202102,135,31,91,49,42
1678,2102,PUNO,AZANGARO,202103,69,16,69,46,23
1680,2102,PUNO,AZANGARO,202104,100,17,85,44,41
1682,2102,PUNO,AZANGARO,202105,207,22,93,55,38
1684,2102,PUNO,AZANGARO,202106,176,37,111,69,42
1686,2102,PUNO,AZANGARO,202107,104,14,70,50,20
1688,2102,PUNO,AZANGARO,202108,64,4,40,60,-20
1695,2103,PUNO,CARABAYA,202003,0,0,17,17,0
1697,2103,PUNO,CARABAYA,202004,1,0,21,16,5
1699,2103,PUNO,CARABAYA,202005,7,0,13,13,0
1701,2103,PUNO,CARABAYA,202006,18,1,19,8,11
1703,2103,PUNO,CARABAYA,202007,29,3,18,12,6
1705,2103,PUNO,CARABAYA,202008,158,15,42,12,30
1707,2103,PUNO,CARABAYA,202009,145,2,10,9,1
1708,2103,PUNO,CARABAYA,202010,59,2,26,18,8
1709,2103,PUNO,CARABAYA,202011,65,2,21,20,1
1710,2103,PUNO,CARABAYA,202012,53,2,22,15,7
1693,2103,PUNO,CARABAYA,202101,63,6,26,11,15
1694,2103,PUNO,CARABAYA,202102,186,14,46,21,25
1696,2103,PUNO,CARABAYA,202103,197,18,40,17,23
1698,2103,PUNO,CARABAYA,202104,153,11,32,16,16
1700,2103,PUNO,CARABAYA,202105,161,19,34,13,21
1702,2103,PUNO,CARABAYA,202106,102,12,35,8,27
1704,2103,PUNO,CARABAYA,202107,101,6,23,12,11
1706,2103,PUNO,CARABAYA,202108,69,3,25,12,13
1713,2104,PUNO,CHUCUITO,202003,0,1,10,10,0
1715,2104,PUNO,CHUCUITO,202004,19,0,5,6,-1
1717,2104,PUNO,CHUCUITO,202005,10,0,11,9,2
1719,2104,PUNO,CHUCUITO,202006,9,0,11,10,1
1721,2104,PUNO,CHUCUITO,202007,94,8,15,7,8
1723,2104,PUNO,CHUCUITO,202008,238,24,34,11,23
1725,2104,PUNO,CHUCUITO,202009,144,16,35,8,27
1726,2104,PUNO,CHUCUITO,202010,74,2,19,5,14
1727,2104,PUNO,CHUCUITO,202011,66,1,21,8,13
1728,2104,PUNO,CHUCUITO,202012,34,2,44,11,33
1711,2104,PUNO,CHUCUITO,202101,64,26,95,20,75
1712,2104,PUNO,CHUCUITO,202102,69,25,72,5,67
1714,2104,PUNO,CHUCUITO,202103,97,15,66,10,56
1716,2104,PUNO,CHUCUITO,202104,179,15,78,6,72
1718,2104,PUNO,CHUCUITO,202105,152,15,55,9,46
1720,2104,PUNO,CHUCUITO,202106,98,10,60,10,50
1722,2104,PUNO,CHUCUITO,202107,74,8,51,7,44
1724,2104,PUNO,CHUCUITO,202108,46,3,34,11,23
1731,2105,PUNO,EL COLLAO,202003,0,0,7,11,-4
1733,2105,PUNO,EL COLLAO,202004,6,0,17,25,-8
1735,2105,PUNO,EL COLLAO,202005,24,0,26,23,3
1737,2105,PUNO,EL COLLAO,202006,6,0,30,11,19
1739,2105,PUNO,EL COLLAO,202007,57,11,42,24,18
1741,2105,PUNO,EL COLLAO,202008,157,29,80,33,47
1743,2105,PUNO,EL COLLAO,202009,112,15,43,32,11
1744,2105,PUNO,EL COLLAO,202010,100,8,41,25,16
1745,2105,PUNO,EL COLLAO,202011,75,4,44,11,33
1746,2105,PUNO,EL COLLAO,202012,17,1,42,7,35
1729,2105,PUNO,EL COLLAO,202101,66,9,73,23,50
1730,2105,PUNO,EL COLLAO,202102,74,18,70,23,47
1732,2105,PUNO,EL COLLAO,202103,87,15,56,11,45
1734,2105,PUNO,EL COLLAO,202104,149,30,87,25,62
1736,2105,PUNO,EL COLLAO,202105,101,28,90,23,67
1738,2105,PUNO,EL COLLAO,202106,50,12,58,11,47
1740,2105,PUNO,EL COLLAO,202107,44,11,51,24,27
1742,2105,PUNO,EL COLLAO,202108,27,4,43,33,10
1749,2106,PUNO,HUANCANE,202003,0,0,44,53,-9
1751,2106,PUNO,HUANCANE,202004,8,1,44,31,13
1753,2106,PUNO,HUANCANE,202005,19,3,33,44,-11
1755,2106,PUNO,HUANCANE,202006,10,5,43,38,5
1757,2106,PUNO,HUANCANE,202007,33,9,58,76,-18
1759,2106,PUNO,HUANCANE,202008,182,16,111,52,59
1761,2106,PUNO,HUANCANE,202009,146,8,42,42,0
1762,2106,PUNO,HUANCANE,202010,86,8,52,44,8
1763,2106,PUNO,HUANCANE,202011,50,3,66,50,16
1764,2106,PUNO,HUANCANE,202012,39,4,56,47,9
1747,2106,PUNO,HUANCANE,202101,41,8,69,53,16
1748,2106,PUNO,HUANCANE,202102,78,17,80,30,50
1750,2106,PUNO,HUANCANE,202103,47,10,78,53,25
1752,2106,PUNO,HUANCANE,202104,40,10,61,31,30
1754,2106,PUNO,HUANCANE,202105,77,10,74,44,30
1756,2106,PUNO,HUANCANE,202106,58,12,75,38,37
1758,2106,PUNO,HUANCANE,202107,47,12,66,76,-10
1760,2106,PUNO,HUANCANE,202108,21,3,49,52,-3
1767,2107,PUNO,LAMPA,202003,0,0,13,27,-14
1769,2107,PUNO,LAMPA,202004,0,0,20,15,5
1771,2107,PUNO,LAMPA,202005,12,0,7,23,-16
1773,2107,PUNO,LAMPA,202006,16,3,13,12,1
1775,2107,PUNO,LAMPA,202007,11,4,20,16,4
1777,2107,PUNO,LAMPA,202008,155,15,41,20,21
1779,2107,PUNO,LAMPA,202009,207,5,18,18,0
1780,2107,PUNO,LAMPA,202010,97,3,14,20,-6
1781,2107,PUNO,LAMPA,202011,49,0,10,15,-5
1782,2107,PUNO,LAMPA,202012,23,2,16,15,1
1765,2107,PUNO,LAMPA,202101,66,7,33,21,12
1766,2107,PUNO,LAMPA,202102,88,8,37,17,20
1768,2107,PUNO,LAMPA,202103,102,10,32,27,5
1770,2107,PUNO,LAMPA,202104,115,7,24,15,9
1772,2107,PUNO,LAMPA,202105,172,19,48,23,25
1774,2107,PUNO,LAMPA,202106,118,15,46,12,34
1776,2107,PUNO,LAMPA,202107,70,8,45,16,29
1778,2107,PUNO,LAMPA,202108,43,3,25,20,5
1785,2108,PUNO,MELGAR,202003,0,0,39,33,6
1787,2108,PUNO,MELGAR,202004,3,0,26,31,-5
1789,2108,PUNO,MELGAR,202005,16,0,31,39,-8
1791,2108,PUNO,MELGAR,202006,47,0,31,31,0
1793,2108,PUNO,MELGAR,202007,38,5,41,30,11
1795,2108,PUNO,MELGAR,202008,274,18,73,38,35
1797,2108,PUNO,MELGAR,202009,236,21,58,36,22
1798,2108,PUNO,MELGAR,202010,57,6,41,35,6
1799,2108,PUNO,MELGAR,202011,53,4,24,44,-20
1800,2108,PUNO,MELGAR,202012,24,3,41,38,3
1783,2108,PUNO,MELGAR,202101,78,10,53,35,18
1784,2108,PUNO,MELGAR,202102,153,12,51,41,10
1786,2108,PUNO,MELGAR,202103,124,14,54,33,21
1788,2108,PUNO,MELGAR,202104,229,22,72,31,41
1790,2108,PUNO,MELGAR,202105,255,30,85,39,46
1792,2108,PUNO,MELGAR,202106,252,24,58,31,27
1794,2108,PUNO,MELGAR,202107,149,10,58,30,28
1796,2108,PUNO,MELGAR,202108,53,2,27,38,-11
1803,2109,PUNO,MOHO,202003,0,0,11,19,-8
1805,2109,PUNO,MOHO,202004,0,0,15,14,1
1807,2109,PUNO,MOHO,202005,3,0,20,17,3
1809,2109,PUNO,MOHO,202006,0,0,15,22,-7
1811,2109,PUNO,MOHO,202007,7,2,19,22,-3
1813,2109,PUNO,MOHO,202008,23,4,43,14,29
1815,2109,PUNO,MOHO,202009,43,6,41,17,24
1816,2109,PUNO,MOHO,202010,26,4,15,16,-1
1817,2109,PUNO,MOHO,202011,20,1,14,19,-5
1818,2109,PUNO,MOHO,202012,6,1,24,17,7
1801,2109,PUNO,MOHO,202101,0,1,19,17,2
1802,2109,PUNO,MOHO,202102,8,2,33,17,16
1804,2109,PUNO,MOHO,202103,17,5,38,19,19
1806,2109,PUNO,MOHO,202104,8,2,28,14,14
1808,2109,PUNO,MOHO,202105,16,0,27,17,10
1810,2109,PUNO,MOHO,202106,17,3,19,22,-3
1812,2109,PUNO,MOHO,202107,10,3,27,22,5
1814,2109,PUNO,MOHO,202108,1,3,23,14,9
1839,2110,PUNO,SAN ANTONIO DE PUTINA,202003,0,0,7,20,-13
1841,2110,PUNO,SAN ANTONIO DE PUTINA,202004,2,0,13,15,-2
1843,2110,PUNO,SAN ANTONIO DE PUTINA,202005,1,0,20,24,-4
1845,2110,PUNO,SAN ANTONIO DE PUTINA,202006,3,1,20,17,3
1847,2110,PUNO,SAN ANTONIO DE PUTINA,202007,19,1,17,14,3
1849,2110,PUNO,SAN ANTONIO DE PUTINA,202008,117,8,24,17,7
1851,2110,PUNO,SAN ANTONIO DE PUTINA,202009,42,7,21,14,7
1852,2110,PUNO,SAN ANTONIO DE PUTINA,202010,54,1,12,15,-3
1853,2110,PUNO,SAN ANTONIO DE PUTINA,202011,34,1,14,17,-3
1854,2110,PUNO,SAN ANTONIO DE PUTINA,202012,16,0,14,14,0
1837,2110,PUNO,SAN ANTONIO DE PUTINA,202101,17,2,22,13,9
1838,2110,PUNO,SAN ANTONIO DE PUTINA,202102,36,6,25,13,12
1840,2110,PUNO,SAN ANTONIO DE PUTINA,202103,29,5,24,20,4
1842,2110,PUNO,SAN ANTONIO DE PUTINA,202104,35,4,23,15,8
1844,2110,PUNO,SAN ANTONIO DE PUTINA,202105,98,5,31,24,7
1846,2110,PUNO,SAN ANTONIO DE PUTINA,202106,73,6,26,17,9
1848,2110,PUNO,SAN ANTONIO DE PUTINA,202107,33,2,19,14,5
1850,2110,PUNO,SAN ANTONIO DE PUTINA,202108,22,4,19,17,2
1857,2111,PUNO,SAN ROMAN,202003,0,0,86,134,-48
1859,2111,PUNO,SAN ROMAN,202004,34,2,78,132,-54
1861,2111,PUNO,SAN ROMAN,202005,140,3,90,112,-22
1863,2111,PUNO,SAN ROMAN,202006,252,19,94,128,-34
1865,2111,PUNO,SAN ROMAN,202007,527,107,250,152,98
1867,2111,PUNO,SAN ROMAN,202008,2977,261,581,125,456
1869,2111,PUNO,SAN ROMAN,202009,1805,95,196,131,65
1870,2111,PUNO,SAN ROMAN,202010,687,33,129,131,-2
1871,2111,PUNO,SAN ROMAN,202011,335,17,137,120,17
1872,2111,PUNO,SAN ROMAN,202012,350,19,114,141,-27
1855,2111,PUNO,SAN ROMAN,202101,458,54,184,114,70
1856,2111,PUNO,SAN ROMAN,202102,702,129,260,117,143
1858,2111,PUNO,SAN ROMAN,202103,512,91,234,134,100
1860,2111,PUNO,SAN ROMAN,202104,663,87,223,132,91
1862,2111,PUNO,SAN ROMAN,202105,916,151,307,112,195
1864,2111,PUNO,SAN ROMAN,202106,750,130,263,128,135
1866,2111,PUNO,SAN ROMAN,202107,486,62,181,152,29
1868,2111,PUNO,SAN ROMAN,202108,272,28,150,125,25
1875,2112,PUNO,SANDIA,202003,0,0,8,12,-4
1877,2112,PUNO,SANDIA,202004,6,1,11,13,-2
1879,2112,PUNO,SANDIA,202005,5,1,11,11,0
1881,2112,PUNO,SANDIA,202006,15,2,15,8,7
1883,2112,PUNO,SANDIA,202007,24,3,13,10,3
1885,2112,PUNO,SANDIA,202008,105,9,16,8,8
1887,2112,PUNO,SANDIA,202009,115,4,15,12,3
1888,2112,PUNO,SANDIA,202010,37,1,10,18,-8
1889,2112,PUNO,SANDIA,202011,36,5,16,6,10
1890,2112,PUNO,SANDIA,202012,17,4,14,9,5
1873,2112,PUNO,SANDIA,202101,22,4,22,7,15
1874,2112,PUNO,SANDIA,202102,34,8,35,11,24
1876,2112,PUNO,SANDIA,202103,55,9,39,12,27
1878,2112,PUNO,SANDIA,202104,26,11,36,13,23
1880,2112,PUNO,SANDIA,202105,51,8,35,11,24
1882,2112,PUNO,SANDIA,202106,39,7,31,8,23
1884,2112,PUNO,SANDIA,202107,52,4,30,10,20
1886,2112,PUNO,SANDIA,202108,35,6,22,8,14
1893,2113,PUNO,YUNGUYO,202003,0,0,17,22,-5
1895,2113,PUNO,YUNGUYO,202004,9,0,17,17,0
1897,2113,PUNO,YUNGUYO,202005,9,2,23,17,6
1899,2113,PUNO,YUNGUYO,202006,7,1,12,15,-3
1901,2113,PUNO,YUNGUYO,202007,18,9,37,11,26
1903,2113,PUNO,YUNGUYO,202008,104,14,49,17,32
1905,2113,PUNO,YUNGUYO,202009,47,7,41,23,18
1906,2113,PUNO,YUNGUYO,202010,47,2,20,15,5
1907,2113,PUNO,YUNGUYO,202011,40,1,26,10,16
1908,2113,PUNO,YUNGUYO,202012,25,8,37,17,20
1891,2113,PUNO,YUNGUYO,202101,64,10,58,18,40
1892,2113,PUNO,YUNGUYO,202102,106,30,78,16,62
1894,2113,PUNO,YUNGUYO,202103,49,5,34,22,12
1896,2113,PUNO,YUNGUYO,202104,74,12,40,17,23
1898,2113,PUNO,YUNGUYO,202105,138,21,53,17,36
1900,2113,PUNO,YUNGUYO,202106,82,8,47,15,32
1902,2113,PUNO,YUNGUYO,202107,48,7,36,11,25
1904,2113,PUNO,YUNGUYO,202108,19,3,23,17,6
2073,2201,SAN MARTIN,MOYOBAMBA,202003,1,1,39,53,-14
2075,2201,SAN MARTIN,MOYOBAMBA,202004,65,2,30,29,1
2077,2201,SAN MARTIN,MOYOBAMBA,202005,262,2,34,35,-1
2079,2201,SAN MARTIN,MOYOBAMBA,202006,454,17,60,33,27
2081,2201,SAN MARTIN,MOYOBAMBA,202007,647,62,96,49,47
2083,2201,SAN MARTIN,MOYOBAMBA,202008,796,29,60,30,30
2085,2201,SAN MARTIN,MOYOBAMBA,202009,552,23,42,51,-9
2086,2201,SAN MARTIN,MOYOBAMBA,202010,296,15,35,47,-12
2087,2201,SAN MARTIN,MOYOBAMBA,202011,143,7,44,37,7
2088,2201,SAN MARTIN,MOYOBAMBA,202012,155,6,38,45,-7
2071,2201,SAN MARTIN,MOYOBAMBA,202101,436,10,41,33,8
2072,2201,SAN MARTIN,MOYOBAMBA,202102,636,19,41,46,-5
2074,2201,SAN MARTIN,MOYOBAMBA,202103,1167,51,100,53,47
2076,2201,SAN MARTIN,MOYOBAMBA,202104,1280,74,120,29,91
2078,2201,SAN MARTIN,MOYOBAMBA,202105,720,48,93,35,58
2080,2201,SAN MARTIN,MOYOBAMBA,202106,434,20,66,33,33
2082,2201,SAN MARTIN,MOYOBAMBA,202107,139,5,53,49,4
2084,2201,SAN MARTIN,MOYOBAMBA,202108,105,7,38,30,8
2091,2202,SAN MARTIN,BELLAVISTA,202003,0,0,14,11,3
2093,2202,SAN MARTIN,BELLAVISTA,202004,30,0,9,8,1
2095,2202,SAN MARTIN,BELLAVISTA,202005,40,7,14,10,4
2097,2202,SAN MARTIN,BELLAVISTA,202006,151,11,15,18,-3
2099,2202,SAN MARTIN,BELLAVISTA,202007,231,36,42,11,31
2101,2202,SAN MARTIN,BELLAVISTA,202008,324,10,22,12,10
2103,2202,SAN MARTIN,BELLAVISTA,202009,160,5,14,15,-1
2104,2202,SAN MARTIN,BELLAVISTA,202010,182,2,16,15,1
2105,2202,SAN MARTIN,BELLAVISTA,202011,84,3,25,17,8
2106,2202,SAN MARTIN,BELLAVISTA,202012,33,3,19,11,8
2089,2202,SAN MARTIN,BELLAVISTA,202101,62,7,20,9,11
2090,2202,SAN MARTIN,BELLAVISTA,202102,60,6,24,8,16
2092,2202,SAN MARTIN,BELLAVISTA,202103,211,26,38,11,27
2094,2202,SAN MARTIN,BELLAVISTA,202104,230,40,50,8,42
2096,2202,SAN MARTIN,BELLAVISTA,202105,122,17,34,10,24
2098,2202,SAN MARTIN,BELLAVISTA,202106,57,2,18,18,0
2100,2202,SAN MARTIN,BELLAVISTA,202107,30,12,29,11,18
2102,2202,SAN MARTIN,BELLAVISTA,202108,16,4,17,12,5
2109,2203,SAN MARTIN,EL DORADO,202003,0,0,15,8,7
2111,2203,SAN MARTIN,EL DORADO,202004,1,1,5,4,1
2113,2203,SAN MARTIN,EL DORADO,202005,30,1,14,7,7
2115,2203,SAN MARTIN,EL DORADO,202006,112,10,20,13,7
2117,2203,SAN MARTIN,EL DORADO,202007,425,18,40,10,30
2119,2203,SAN MARTIN,EL DORADO,202008,257,8,21,6,15
2121,2203,SAN MARTIN,EL DORADO,202009,269,4,17,13,4
2122,2203,SAN MARTIN,EL DORADO,202010,247,6,12,7,5
2123,2203,SAN MARTIN,EL DORADO,202011,211,1,9,8,1
2124,2203,SAN MARTIN,EL DORADO,202012,218,1,16,10,6
2107,2203,SAN MARTIN,EL DORADO,202101,61,3,9,11,-2
2108,2203,SAN MARTIN,EL DORADO,202102,34,2,13,4,9
2110,2203,SAN MARTIN,EL DORADO,202103,98,4,20,8,12
2112,2203,SAN MARTIN,EL DORADO,202104,90,10,23,4,19
2114,2203,SAN MARTIN,EL DORADO,202105,48,3,15,7,8
2116,2203,SAN MARTIN,EL DORADO,202106,36,1,14,13,1
2118,2203,SAN MARTIN,EL DORADO,202107,46,3,13,10,3
2120,2203,SAN MARTIN,EL DORADO,202108,13,1,11,6,5
2127,2204,SAN MARTIN,HUALLAGA,202003,0,1,9,8,1
2129,2204,SAN MARTIN,HUALLAGA,202004,0,0,11,15,-4
2131,2204,SAN MARTIN,HUALLAGA,202005,28,0,10,4,6
2133,2204,SAN MARTIN,HUALLAGA,202006,66,6,18,6,12
2135,2204,SAN MARTIN,HUALLAGA,202007,143,18,32,7,25
2137,2204,SAN MARTIN,HUALLAGA,202008,213,19,27,13,14
2139,2204,SAN MARTIN,HUALLAGA,202009,142,6,9,15,-6
2140,2204,SAN MARTIN,HUALLAGA,202010,204,1,7,16,-9
2141,2204,SAN MARTIN,HUALLAGA,202011,187,1,3,10,-7
2142,2204,SAN MARTIN,HUALLAGA,202012,73,0,15,5,10
2125,2204,SAN MARTIN,HUALLAGA,202101,118,3,17,10,7
2126,2204,SAN MARTIN,HUALLAGA,202102,90,3,15,12,3
2128,2204,SAN MARTIN,HUALLAGA,202103,86,5,15,8,7
2130,2204,SAN MARTIN,HUALLAGA,202104,154,13,28,15,13
2132,2204,SAN MARTIN,HUALLAGA,202105,84,12,28,4,24
2134,2204,SAN MARTIN,HUALLAGA,202106,81,5,17,6,11
2136,2204,SAN MARTIN,HUALLAGA,202107,48,1,16,7,9
2138,2204,SAN MARTIN,HUALLAGA,202108,8,1,10,13,-3
2145,2205,SAN MARTIN,LAMAS,202003,0,0,24,31,-7
2147,2205,SAN MARTIN,LAMAS,202004,2,0,19,36,-17
2149,2205,SAN MARTIN,LAMAS,202005,73,2,32,30,2
2151,2205,SAN MARTIN,LAMAS,202006,185,20,48,26,22
2153,2205,SAN MARTIN,LAMAS,202007,215,43,82,27,55
2155,2205,SAN MARTIN,LAMAS,202008,502,23,49,25,24
2157,2205,SAN MARTIN,LAMAS,202009,341,10,35,30,5
2158,2205,SAN MARTIN,LAMAS,202010,281,5,28,22,6
2159,2205,SAN MARTIN,LAMAS,202011,263,6,34,40,-6
2160,2205,SAN MARTIN,LAMAS,202012,189,2,30,44,-14
2143,2205,SAN MARTIN,LAMAS,202101,192,3,30,36,-6
2144,2205,SAN MARTIN,LAMAS,202102,119,15,42,26,16
2146,2205,SAN MARTIN,LAMAS,202103,294,22,52,31,21
2148,2205,SAN MARTIN,LAMAS,202104,378,20,59,36,23
2150,2205,SAN MARTIN,LAMAS,202105,148,26,69,30,39
2152,2205,SAN MARTIN,LAMAS,202106,149,8,47,26,21
2154,2205,SAN MARTIN,LAMAS,202107,52,2,42,27,15
2156,2205,SAN MARTIN,LAMAS,202108,38,6,30,25,5
2163,2206,SAN MARTIN,MARISCAL CACERES,202003,1,0,20,19,1
2165,2206,SAN MARTIN,MARISCAL CACERES,202004,7,0,15,18,-3
2167,2206,SAN MARTIN,MARISCAL CACERES,202005,120,15,28,8,20
2169,2206,SAN MARTIN,MARISCAL CACERES,202006,325,99,111,9,102
2171,2206,SAN MARTIN,MARISCAL CACERES,202007,210,33,49,12,37
2173,2206,SAN MARTIN,MARISCAL CACERES,202008,465,18,32,9,23
2175,2206,SAN MARTIN,MARISCAL CACERES,202009,288,8,26,14,12
2176,2206,SAN MARTIN,MARISCAL CACERES,202010,185,5,18,11,7
2177,2206,SAN MARTIN,MARISCAL CACERES,202011,144,3,25,7,18
2178,2206,SAN MARTIN,MARISCAL CACERES,202012,52,1,20,16,4
2161,2206,SAN MARTIN,MARISCAL CACERES,202101,81,7,32,12,20
2162,2206,SAN MARTIN,MARISCAL CACERES,202102,53,3,20,15,5
2164,2206,SAN MARTIN,MARISCAL CACERES,202103,110,6,31,19,12
2166,2206,SAN MARTIN,MARISCAL CACERES,202104,261,32,53,18,35
2168,2206,SAN MARTIN,MARISCAL CACERES,202105,134,29,56,8,48
2170,2206,SAN MARTIN,MARISCAL CACERES,202106,57,10,25,9,16
2172,2206,SAN MARTIN,MARISCAL CACERES,202107,71,3,19,12,7
2174,2206,SAN MARTIN,MARISCAL CACERES,202108,42,3,22,9,13
2181,2207,SAN MARTIN,PICOTA,202003,0,0,2,6,-4
2183,2207,SAN MARTIN,PICOTA,202004,39,0,3,8,-5
2185,2207,SAN MARTIN,PICOTA,202005,86,9,12,8,4
2187,2207,SAN MARTIN,PICOTA,202006,59,37,42,11,31
2189,2207,SAN MARTIN,PICOTA,202007,48,27,31,13,18
2191,2207,SAN MARTIN,PICOTA,202008,209,7,14,7,7
2193,2207,SAN MARTIN,PICOTA,202009,83,8,15,8,7
2194,2207,SAN MARTIN,PICOTA,202010,90,0,8,11,-3
2195,2207,SAN MARTIN,PICOTA,202011,124,2,18,7,11
2196,2207,SAN MARTIN,PICOTA,202012,113,1,9,8,1
2179,2207,SAN MARTIN,PICOTA,202101,57,3,16,8,8
2180,2207,SAN MARTIN,PICOTA,202102,74,2,21,9,12
2182,2207,SAN MARTIN,PICOTA,202103,174,6,22,6,16
2184,2207,SAN MARTIN,PICOTA,202104,321,22,36,8,28
2186,2207,SAN MARTIN,PICOTA,202105,153,14,30,8,22
2188,2207,SAN MARTIN,PICOTA,202106,49,5,19,11,8
2190,2207,SAN MARTIN,PICOTA,202107,65,7,19,13,6
2192,2207,SAN MARTIN,PICOTA,202108,22,1,18,7,11
2199,2208,SAN MARTIN,RIOJA,202003,2,0,31,31,0
2201,2208,SAN MARTIN,RIOJA,202004,16,2,36,38,-2
2203,2208,SAN MARTIN,RIOJA,202005,91,2,34,32,2
2205,2208,SAN MARTIN,RIOJA,202006,281,17,54,35,19
2207,2208,SAN MARTIN,RIOJA,202007,364,23,68,39,29
2209,2208,SAN MARTIN,RIOJA,202008,635,52,91,44,47
2211,2208,SAN MARTIN,RIOJA,202009,405,13,47,51,-4
2212,2208,SAN MARTIN,RIOJA,202010,788,7,40,49,-9
2213,2208,SAN MARTIN,RIOJA,202011,243,6,36,33,3
2214,2208,SAN MARTIN,RIOJA,202012,247,4,48,49,-1
2197,2208,SAN MARTIN,RIOJA,202101,140,7,57,27,30
2198,2208,SAN MARTIN,RIOJA,202102,277,22,59,25,34
2200,2208,SAN MARTIN,RIOJA,202103,836,32,78,31,47
2202,2208,SAN MARTIN,RIOJA,202104,1023,67,127,38,89
2204,2208,SAN MARTIN,RIOJA,202105,364,33,83,32,51
2206,2208,SAN MARTIN,RIOJA,202106,156,15,79,35,44
2208,2208,SAN MARTIN,RIOJA,202107,139,3,66,39,27
2210,2208,SAN MARTIN,RIOJA,202108,59,1,61,44,17
2217,2209,SAN MARTIN,SAN MARTIN,202003,1,1,44,79,-35
2219,2209,SAN MARTIN,SAN MARTIN,202004,95,2,41,47,-6
2221,2209,SAN MARTIN,SAN MARTIN,202005,355,26,62,60,2
2223,2209,SAN MARTIN,SAN MARTIN,202006,2296,346,386,56,330
2225,2209,SAN MARTIN,SAN MARTIN,202007,1545,143,186,60,126
2227,2209,SAN MARTIN,SAN MARTIN,202008,1031,39,89,45,44
2229,2209,SAN MARTIN,SAN MARTIN,202009,1327,23,73,62,11
2230,2209,SAN MARTIN,SAN MARTIN,202010,856,15,63,37,26
2231,2209,SAN MARTIN,SAN MARTIN,202011,477,13,69,55,14
2232,2209,SAN MARTIN,SAN MARTIN,202012,223,7,78,69,9
2215,2209,SAN MARTIN,SAN MARTIN,202101,627,17,90,58,32
2216,2209,SAN MARTIN,SAN MARTIN,202102,651,25,71,59,12
2218,2209,SAN MARTIN,SAN MARTIN,202103,1209,76,145,79,66
2220,2209,SAN MARTIN,SAN MARTIN,202104,2054,126,199,47,152
2222,2209,SAN MARTIN,SAN MARTIN,202105,1210,106,186,60,126
2224,2209,SAN MARTIN,SAN MARTIN,202106,715,45,108,56,52
2226,2209,SAN MARTIN,SAN MARTIN,202107,618,29,100,60,40
2228,2209,SAN MARTIN,SAN MARTIN,202108,240,18,102,45,57
2235,2210,SAN MARTIN,TOCACHE,202003,0,0,17,11,6
2237,2210,SAN MARTIN,TOCACHE,202004,7,1,13,14,-1
2239,2210,SAN MARTIN,TOCACHE,202005,94,0,14,16,-2
2241,2210,SAN MARTIN,TOCACHE,202006,197,13,22,9,13
2243,2210,SAN MARTIN,TOCACHE,202007,281,38,68,15,53
2245,2210,SAN MARTIN,TOCACHE,202008,517,25,45,26,19
2247,2210,SAN MARTIN,TOCACHE,202009,363,12,21,16,5
2248,2210,SAN MARTIN,TOCACHE,202010,414,7,20,13,7
2249,2210,SAN MARTIN,TOCACHE,202011,221,5,30,19,11
2250,2210,SAN MARTIN,TOCACHE,202012,103,5,25,15,10
2233,2210,SAN MARTIN,TOCACHE,202101,189,7,20,16,4
2234,2210,SAN MARTIN,TOCACHE,202102,267,9,28,12,16
2236,2210,SAN MARTIN,TOCACHE,202103,285,12,38,11,27
2238,2210,SAN MARTIN,TOCACHE,202104,481,21,41,14,27
2240,2210,SAN MARTIN,TOCACHE,202105,275,26,47,16,31
2242,2210,SAN MARTIN,TOCACHE,202106,86,10,28,9,19
2244,2210,SAN MARTIN,TOCACHE,202107,90,6,20,15,5
2246,2210,SAN MARTIN,TOCACHE,202108,61,6,24,26,-2
2253,2301,TACNA,TACNA,202003,2,0,76,83,-7
2255,2301,TACNA,TACNA,202004,158,2,55,69,-14
2257,2301,TACNA,TACNA,202005,428,12,79,83,-4
2259,2301,TACNA,TACNA,202006,506,23,83,83,0
2261,2301,TACNA,TACNA,202007,1869,152,202,93,109
2263,2301,TACNA,TACNA,202008,5500,375,379,102,277
2265,2301,TACNA,TACNA,202009,2840,125,155,87,68
2266,2301,TACNA,TACNA,202010,837,33,70,81,-11
2267,2301,TACNA,TACNA,202011,897,25,57,74,-17
2268,2301,TACNA,TACNA,202012,673,20,68,68,0
2251,2301,TACNA,TACNA,202101,2304,174,200,102,98
2252,2301,TACNA,TACNA,202102,3090,312,313,114,199
2254,2301,TACNA,TACNA,202103,1647,164,182,83,99
2256,2301,TACNA,TACNA,202104,1367,96,132,69,63
2258,2301,TACNA,TACNA,202105,1890,147,165,83,82
2260,2301,TACNA,TACNA,202106,2049,127,165,83,82
2262,2301,TACNA,TACNA,202107,1256,67,149,93,56
2264,2301,TACNA,TACNA,202108,412,13,90,102,-12
2271,2302,TACNA,CANDARAVE,202003,0,0,1,4,-3
2273,2302,TACNA,CANDARAVE,202004,0,0,1,2,-1
2275,2302,TACNA,CANDARAVE,202005,0,0,4,2,2
2277,2302,TACNA,CANDARAVE,202006,0,1,1,4,-3
2279,2302,TACNA,CANDARAVE,202007,3,0,1,2,-1
2281,2302,TACNA,CANDARAVE,202008,40,3,6,3,3
2283,2302,TACNA,CANDARAVE,202009,87,1,4,2,2
2284,2302,TACNA,CANDARAVE,202010,0,0,1,2,-1
2285,2302,TACNA,CANDARAVE,202011,3,0,3,1,2
2286,2302,TACNA,CANDARAVE,202012,0,0,2,3,-1
2269,2302,TACNA,CANDARAVE,202101,13,2,5,3,2
2270,2302,TACNA,CANDARAVE,202102,14,2,10,2,8
2272,2302,TACNA,CANDARAVE,202103,7,0,5,4,1
2274,2302,TACNA,CANDARAVE,202104,33,2,7,2,5
2276,2302,TACNA,CANDARAVE,202105,13,0,4,2,2
2278,2302,TACNA,CANDARAVE,202106,12,1,5,4,1
2280,2302,TACNA,CANDARAVE,202107,5,0,3,2,1
2282,2302,TACNA,CANDARAVE,202108,5,0,2,3,-1
2289,2303,TACNA,JORGE BASADRE,202003,0,0,1,4,-3
2291,2303,TACNA,JORGE BASADRE,202004,1,0,2,3,-1
2293,2303,TACNA,JORGE BASADRE,202005,4,1,2,0,2
2295,2303,TACNA,JORGE BASADRE,202006,10,0,2,4,-2
2297,2303,TACNA,JORGE BASADRE,202007,45,4,2,3,-1
2299,2303,TACNA,JORGE BASADRE,202008,81,8,14,2,12
2301,2303,TACNA,JORGE BASADRE,202009,242,2,7,2,5
2302,2303,TACNA,JORGE BASADRE,202010,4,0,2,4,-2
2303,2303,TACNA,JORGE BASADRE,202011,8,0,0,2,-2
2304,2303,TACNA,JORGE BASADRE,202012,11,0,1,5,-4
2287,2303,TACNA,JORGE BASADRE,202101,37,1,5,1,4
2288,2303,TACNA,JORGE BASADRE,202102,42,6,11,4,7
2290,2303,TACNA,JORGE BASADRE,202103,50,3,5,4,1
2292,2303,TACNA,JORGE BASADRE,202104,51,2,5,3,2
2294,2303,TACNA,JORGE BASADRE,202105,76,2,3,0,3
2296,2303,TACNA,JORGE BASADRE,202106,126,3,6,4,2
2298,2303,TACNA,JORGE BASADRE,202107,62,2,3,3,0
2300,2303,TACNA,JORGE BASADRE,202108,13,0,2,2,0
2307,2304,TACNA,TARATA,202003,0,0,1,2,-1
2309,2304,TACNA,TARATA,202004,1,0,2,1,1
2311,2304,TACNA,TARATA,202005,0,0,3,2,1
2313,2304,TACNA,TARATA,202006,4,0,4,10,-6
2315,2304,TACNA,TARATA,202007,2,2,4,5,-1
2317,2304,TACNA,TARATA,202008,18,1,9,7,2
2319,2304,TACNA,TARATA,202009,90,5,8,4,4
2320,2304,TACNA,TARATA,202010,11,2,4,5,-1
2321,2304,TACNA,TARATA,202011,7,0,0,1,-1
2322,2304,TACNA,TARATA,202012,7,0,0,3,-3
2305,2304,TACNA,TARATA,202101,3,0,4,1,3
2306,2304,TACNA,TARATA,202102,15,4,6,2,4
2308,2304,TACNA,TARATA,202103,5,3,6,2,4
2310,2304,TACNA,TARATA,202104,16,0,2,1,1
2312,2304,TACNA,TARATA,202105,30,5,9,2,7
2314,2304,TACNA,TARATA,202106,24,5,11,10,1
2316,2304,TACNA,TARATA,202107,22,0,6,5,1
2318,2304,TACNA,TARATA,202108,1,0,3,7,-4
2325,2401,TUMBES,TUMBES,202003,9,0,67,61,6
2327,2401,TUMBES,TUMBES,202004,292,17,85,62,23
2329,2401,TUMBES,TUMBES,202005,742,132,229,57,172
2331,2401,TUMBES,TUMBES,202006,1602,173,245,52,193
2333,2401,TUMBES,TUMBES,202007,1201,77,127,53,74
2335,2401,TUMBES,TUMBES,202008,1224,52,96,61,35
2337,2401,TUMBES,TUMBES,202009,1045,45,82,74,8
2338,2401,TUMBES,TUMBES,202010,640,28,86,58,28
2339,2401,TUMBES,TUMBES,202011,354,18,67,61,6
2340,2401,TUMBES,TUMBES,202012,308,25,81,74,7
2323,2401,TUMBES,TUMBES,202101,763,44,103,68,35
2324,2401,TUMBES,TUMBES,202102,1199,82,152,74,78
2326,2401,TUMBES,TUMBES,202103,1497,149,203,61,142
2328,2401,TUMBES,TUMBES,202104,1431,172,243,62,181
2330,2401,TUMBES,TUMBES,202105,968,102,157,57,100
2332,2401,TUMBES,TUMBES,202106,703,36,90,52,38
2334,2401,TUMBES,TUMBES,202107,261,15,75,53,22
2336,2401,TUMBES,TUMBES,202108,220,8,77,61,16
2343,2402,TUMBES,CONTRALMIRANTE VILLAR,202003,1,0,6,14,-8
2345,2402,TUMBES,CONTRALMIRANTE VILLAR,202004,25,4,11,11,0
2347,2402,TUMBES,CONTRALMIRANTE VILLAR,202005,57,11,20,9,11
2349,2402,TUMBES,CONTRALMIRANTE VILLAR,202006,107,19,26,8,18
2351,2402,TUMBES,CONTRALMIRANTE VILLAR,202007,60,11,19,6,13
2353,2402,TUMBES,CONTRALMIRANTE VILLAR,202008,69,3,4,4,0
2355,2402,TUMBES,CONTRALMIRANTE VILLAR,202009,66,2,7,6,1
2356,2402,TUMBES,CONTRALMIRANTE VILLAR,202010,67,6,9,8,1
2357,2402,TUMBES,CONTRALMIRANTE VILLAR,202011,15,3,5,3,2
2358,2402,TUMBES,CONTRALMIRANTE VILLAR,202012,19,9,14,9,5
2341,2402,TUMBES,CONTRALMIRANTE VILLAR,202101,91,12,24,10,14
2342,2402,TUMBES,CONTRALMIRANTE VILLAR,202102,53,10,21,6,15
2344,2402,TUMBES,CONTRALMIRANTE VILLAR,202103,147,16,19,14,5
2346,2402,TUMBES,CONTRALMIRANTE VILLAR,202104,91,12,21,11,10
2348,2402,TUMBES,CONTRALMIRANTE VILLAR,202105,80,7,15,9,6
2350,2402,TUMBES,CONTRALMIRANTE VILLAR,202106,21,6,13,8,5
2352,2402,TUMBES,CONTRALMIRANTE VILLAR,202107,39,1,9,6,3
2354,2402,TUMBES,CONTRALMIRANTE VILLAR,202108,18,0,9,4,5
2361,2403,TUMBES,ZARUMILLA,202003,4,1,24,20,4
2363,2403,TUMBES,ZARUMILLA,202004,59,12,27,15,12
2365,2403,TUMBES,ZARUMILLA,202005,122,23,40,12,28
2367,2403,TUMBES,ZARUMILLA,202006,257,42,66,11,55
2369,2403,TUMBES,ZARUMILLA,202007,187,16,27,8,19
2371,2403,TUMBES,ZARUMILLA,202008,258,14,31,12,19
2373,2403,TUMBES,ZARUMILLA,202009,384,6,16,12,4
2374,2403,TUMBES,ZARUMILLA,202010,173,6,21,18,3
2375,2403,TUMBES,ZARUMILLA,202011,113,7,26,12,14
2376,2403,TUMBES,ZARUMILLA,202012,42,4,17,11,6
2359,2403,TUMBES,ZARUMILLA,202101,87,10,22,17,5
2360,2403,TUMBES,ZARUMILLA,202102,121,10,25,11,14
2362,2403,TUMBES,ZARUMILLA,202103,322,32,52,20,32
2364,2403,TUMBES,ZARUMILLA,202104,353,30,49,15,34
2366,2403,TUMBES,ZARUMILLA,202105,156,15,29,12,17
2368,2403,TUMBES,ZARUMILLA,202106,95,8,20,11,9
2370,2403,TUMBES,ZARUMILLA,202107,58,5,22,8,14
2372,2403,TUMBES,ZARUMILLA,202108,49,0,20,12,8
2379,2501,UCAYALI,CORONEL PORTILLO,202003,0,9,163,132,31
2381,2501,UCAYALI,CORONEL PORTILLO,202004,752,218,354,119,235
2383,2501,UCAYALI,CORONEL PORTILLO,202005,4049,566,750,160,590
2385,2501,UCAYALI,CORONEL PORTILLO,202006,2557,202,255,154,101
2387,2501,UCAYALI,CORONEL PORTILLO,202007,1788,150,199,147,52
2389,2501,UCAYALI,CORONEL PORTILLO,202008,3335,128,161,144,17
2391,2501,UCAYALI,CORONEL PORTILLO,202009,1863,77,126,178,-52
2392,2501,UCAYALI,CORONEL PORTILLO,202010,965,34,167,168,-1
2393,2501,UCAYALI,CORONEL PORTILLO,202011,690,32,157,138,19
2394,2501,UCAYALI,CORONEL PORTILLO,202012,654,26,151,158,-7
2377,2501,UCAYALI,CORONEL PORTILLO,202101,887,85,196,141,55
2378,2501,UCAYALI,CORONEL PORTILLO,202102,1207,171,234,147,87
2380,2501,UCAYALI,CORONEL PORTILLO,202103,3949,367,356,132,224
2382,2501,UCAYALI,CORONEL PORTILLO,202104,2289,441,490,119,371
2384,2501,UCAYALI,CORONEL PORTILLO,202105,713,168,263,160,103
2386,2501,UCAYALI,CORONEL PORTILLO,202106,309,61,199,154,45
2388,2501,UCAYALI,CORONEL PORTILLO,202107,87,27,169,147,22
2390,2501,UCAYALI,CORONEL PORTILLO,202108,52,23,180,144,36
2397,2502,UCAYALI,ATALAYA,202003,0,0,2,9,-7
2399,2502,UCAYALI,ATALAYA,202004,0,1,4,11,-7
2401,2502,UCAYALI,ATALAYA,202005,1,0,2,7,-5
2403,2502,UCAYALI,ATALAYA,202006,8,9,9,0,9
2405,2502,UCAYALI,ATALAYA,202007,112,15,14,6,8
2407,2502,UCAYALI,ATALAYA,202008,144,9,9,7,2
2409,2502,UCAYALI,ATALAYA,202009,77,7,7,8,-1
2410,2502,UCAYALI,ATALAYA,202010,117,1,6,9,-3
2411,2502,UCAYALI,ATALAYA,202011,11,2,15,3,12
2412,2502,UCAYALI,ATALAYA,202012,13,0,7,5,2
2395,2502,UCAYALI,ATALAYA,202101,34,6,15,4,11
2396,2502,UCAYALI,ATALAYA,202102,19,9,12,8,4
2398,2502,UCAYALI,ATALAYA,202103,53,5,10,9,1
2400,2502,UCAYALI,ATALAYA,202104,27,15,23,11,12
2402,2502,UCAYALI,ATALAYA,202105,40,20,25,7,18
2404,2502,UCAYALI,ATALAYA,202106,7,6,14,0,14
2406,2502,UCAYALI,ATALAYA,202107,12,3,19,6,13
2408,2502,UCAYALI,ATALAYA,202108,5,1,10,7,3
2415,2503,UCAYALI,PADRE ABAD,202003,0,0,7,6,1
2417,2503,UCAYALI,PADRE ABAD,202004,4,3,8,8,0
2419,2503,UCAYALI,PADRE ABAD,202005,130,16,11,11,0
2421,2503,UCAYALI,PADRE ABAD,202006,339,25,19,11,8
2423,2503,UCAYALI,PADRE ABAD,202007,224,13,17,8,9
2425,2503,UCAYALI,PADRE ABAD,202008,346,12,17,9,8
2427,2503,UCAYALI,PADRE ABAD,202009,262,8,11,7,4
2428,2503,UCAYALI,PADRE ABAD,202010,191,4,10,14,-4
2429,2503,UCAYALI,PADRE ABAD,202011,90,6,12,8,4
2430,2503,UCAYALI,PADRE ABAD,202012,90,3,13,9,4
2413,2503,UCAYALI,PADRE ABAD,202101,97,7,19,11,8
2414,2503,UCAYALI,PADRE ABAD,202102,177,15,12,6,6
2416,2503,UCAYALI,PADRE ABAD,202103,337,20,20,6,14
2418,2503,UCAYALI,PADRE ABAD,202104,330,20,17,8,9
2420,2503,UCAYALI,PADRE ABAD,202105,121,19,17,11,6
2422,2503,UCAYALI,PADRE ABAD,202106,24,6,14,11,3
2424,2503,UCAYALI,PADRE ABAD,202107,20,1,8,8,0
2426,2503,UCAYALI,PADRE ABAD,202108,11,5,15,9,6
2433,2504,UCAYALI,PURUS,202003,0,0,0,0,0
2435,2504,UCAYALI,PURUS,202004,0,0,1,2,-1
2437,2504,UCAYALI,PURUS,202005,0,0,0,1,-1
2439,2504,UCAYALI,PURUS,202006,0,0,0,1,-1
2441,2504,UCAYALI,PURUS,202007,23,0,0,1,-1
2443,2504,UCAYALI,PURUS,202008,19,0,1,0,1
2445,2504,UCAYALI,PURUS,202009,122,2,1,2,-1
2446,2504,UCAYALI,PURUS,202010,160,0,0,0,0
2447,2504,UCAYALI,PURUS,202011,27,0,1,0,1
2448,2504,UCAYALI,PURUS,202012,0,0,0,1,-1
2431,2504,UCAYALI,PURUS,202101,7,0,1,0,1
2432,2504,UCAYALI,PURUS,202102,8,0,1,2,-1
2434,2504,UCAYALI,PURUS,202103,44,2,3,0,3
2436,2504,UCAYALI,PURUS,202104,21,0,0,2,-2
2438,2504,UCAYALI,PURUS,202105,2,1,1,1,0
2440,2504,UCAYALI,PURUS,202106,0,0,0,1,-1
2442,2504,UCAYALI,PURUS,202107,0,0,1,1,0
2444,2504,UCAYALI,PURUS,202108,0,1,1,0,1
